,resident_base_year,resident_base_month,resident_emd_nm,resident_sex,resident_resid_reg_pop,resident_foreign_pop,resident_total_pop
0,2018,1,건입동,남성,5085,146,5231
1,2018,1,건입동,여성,4715,82,4797
2,2018,1,구좌읍,남성,7965,368,8333
3,2018,1,구좌읍,여성,7609,184,7793
4,2018,1,남원읍,남성,9806,428,10234
5,2018,1,남원읍,여성,9306,200,9506
6,2018,1,노형동,남성,26286,821,27107
7,2018,1,노형동,여성,27083,768,27851
8,2018,1,대륜동,남성,6836,83,6919
9,2018,1,대륜동,여성,6637,95,6732
10,2018,1,대정읍,남성,10360,841,11201
11,2018,1,대정읍,여성,10725,677,11402
12,2018,1,대천동,남성,6685,107,6792
13,2018,1,대천동,여성,6475,137,6612
14,2018,1,도두동,남성,1602,43,1645
15,2018,1,도두동,여성,1424,55,1479
16,2018,1,동홍동,남성,11124,624,11748
17,2018,1,동홍동,여성,11569,642,12211
18,2018,1,봉개동,남성,2089,37,2126
19,2018,1,봉개동,여성,1838,39,1877
20,2018,1,삼도1동,남성,7057,60,7117
21,2018,1,삼도1동,여성,7348,81,7429
22,2018,1,삼도2동,남성,4500,128,4628
23,2018,1,삼도2동,여성,4188,94,4282
24,2018,1,삼양동,남성,12016,87,12103
25,2018,1,삼양동,여성,11819,158,11977
26,2018,1,서홍동,남성,5302,61,5363
27,2018,1,서홍동,여성,5335,66,5401
28,2018,1,성산읍,남성,8006,1015,9021
29,2018,1,성산읍,여성,7332,560,7892
30,2018,1,송산동,남성,2344,366,2710
31,2018,1,송산동,여성,2111,157,2268
32,2018,1,아라동,남성,15129,488,15617
33,2018,1,아라동,여성,15343,507,15850
34,2018,1,안덕면,남성,5938,258,6196
35,2018,1,안덕면,여성,5524,264,5788
36,2018,1,애월읍,남성,17708,481,18189
37,2018,1,애월읍,여성,16563,454,17017
38,2018,1,연동,남성,20591,703,21294
39,2018,1,연동,여성,21018,926,21944
40,2018,1,영천동,남성,2640,111,2751
41,2018,1,영천동,여성,2526,60,2586
42,2018,1,예래동,남성,2011,69,2080
43,2018,1,예래동,여성,1922,74,1996
44,2018,1,오라동,남성,6889,81,6970
45,2018,1,오라동,여성,6747,112,6859
46,2018,1,외도동,남성,10483,120,10603
47,2018,1,외도동,여성,10345,157,10502
48,2018,1,용담1동,남성,4026,38,4064
49,2018,1,용담1동,여성,3775,48,3823
50,2018,1,용담2동,남성,7965,69,8034
51,2018,1,용담2동,여성,7748,134,7882
52,2018,1,우도면,남성,981,16,997
53,2018,1,우도면,여성,875,16,891
54,2018,1,이도1동,남성,3980,51,4031
55,2018,1,이도1동,여성,3975,81,4056
56,2018,1,이도2동,남성,24510,214,24724
57,2018,1,이도2동,여성,25593,344,25937
58,2018,1,이호동,남성,2152,66,2218
59,2018,1,이호동,여성,2016,71,2087
60,2018,1,일도1동,남성,1586,52,1638
61,2018,1,일도1동,여성,1453,36,1489
62,2018,1,일도2동,남성,17188,92,17280
63,2018,1,일도2동,여성,17797,184,17981
64,2018,1,정방동,남성,1275,49,1324
65,2018,1,정방동,여성,1186,47,1233
66,2018,1,조천읍,남성,12062,289,12351
67,2018,1,조천읍,여성,11394,237,11631
68,2018,1,중문동,남성,5551,138,5689
69,2018,1,중문동,여성,5145,141,5286
70,2018,1,중앙동,남성,1913,43,1956
71,2018,1,중앙동,여성,2086,64,2150
72,2018,1,천지동,남성,1818,49,1867
73,2018,1,천지동,여성,1729,47,1776
74,2018,1,추자면,남성,1020,352,1372
75,2018,1,추자면,여성,842,11,853
76,2018,1,표선면,남성,6279,261,6540
77,2018,1,표선면,여성,5974,148,6122
78,2018,1,한경면,남성,4509,224,4733
79,2018,1,한경면,여성,4441,95,4536
80,2018,1,한림읍,남성,10808,2192,13000
81,2018,1,한림읍,여성,10081,1338,11419
82,2018,1,화북동,남성,12572,215,12787
83,2018,1,화북동,여성,12583,146,12729
84,2018,1,효돈동,남성,2697,48,2745
85,2018,1,효돈동,여성,2628,34,2662
86,2018,2,건입동,남성,5090,142,5232
87,2018,2,건입동,여성,4724,82,4806
88,2018,2,구좌읍,남성,7996,372,8368
89,2018,2,구좌읍,여성,7614,181,7795
90,2018,2,남원읍,남성,9821,430,10251
91,2018,2,남원읍,여성,9321,205,9526
92,2018,2,노형동,남성,26278,866,27144
93,2018,2,노형동,여성,27091,798,27889
94,2018,2,대륜동,남성,6841,86,6927
95,2018,2,대륜동,여성,6678,94,6772
96,2018,2,대정읍,남성,10381,827,11208
97,2018,2,대정읍,여성,10746,676,11422
98,2018,2,대천동,남성,6747,105,6852
99,2018,2,대천동,여성,6506,138,6644
100,2018,2,도두동,남성,1611,43,1654
101,2018,2,도두동,여성,1422,58,1480
102,2018,2,동홍동,남성,11160,620,11780
103,2018,2,동홍동,여성,11567,635,12202
104,2018,2,봉개동,남성,2101,37,2138
105,2018,2,봉개동,여성,1859,40,1899
106,2018,2,삼도1동,남성,7056,64,7120
107,2018,2,삼도1동,여성,7354,83,7437
108,2018,2,삼도2동,남성,4497,128,4625
109,2018,2,삼도2동,여성,4199,97,4296
110,2018,2,삼양동,남성,12126,87,12213
111,2018,2,삼양동,여성,11939,161,12100
112,2018,2,서홍동,남성,5322,57,5379
113,2018,2,서홍동,여성,5344,66,5410
114,2018,2,성산읍,남성,8029,1003,9032
115,2018,2,성산읍,여성,7356,557,7913
116,2018,2,송산동,남성,2349,370,2719
117,2018,2,송산동,여성,2117,159,2276
118,2018,2,아라동,남성,15386,484,15870
119,2018,2,아라동,여성,15607,496,16103
120,2018,2,안덕면,남성,5985,263,6248
121,2018,2,안덕면,여성,5560,270,5830
122,2018,2,애월읍,남성,17777,544,18321
123,2018,2,애월읍,여성,16609,496,17105
124,2018,2,연동,남성,20537,719,21256
125,2018,2,연동,여성,20951,925,21876
126,2018,2,영천동,남성,2638,109,2747
127,2018,2,영천동,여성,2534,61,2595
128,2018,2,예래동,남성,2026,67,2093
129,2018,2,예래동,여성,1931,72,2003
130,2018,2,오라동,남성,6932,83,7015
131,2018,2,오라동,여성,6797,109,6906
132,2018,2,외도동,남성,10520,117,10637
133,2018,2,외도동,여성,10350,155,10505
134,2018,2,용담1동,남성,3991,36,4027
135,2018,2,용담1동,여성,3761,48,3809
136,2018,2,용담2동,남성,7925,69,7994
137,2018,2,용담2동,여성,7713,136,7849
138,2018,2,우도면,남성,982,16,998
139,2018,2,우도면,여성,875,16,891
140,2018,2,이도1동,남성,3969,47,4016
141,2018,2,이도1동,여성,3957,77,4034
142,2018,2,이도2동,남성,24417,216,24633
143,2018,2,이도2동,여성,25488,332,25820
144,2018,2,이호동,남성,2158,67,2225
145,2018,2,이호동,여성,2019,72,2091
146,2018,2,일도1동,남성,1570,52,1622
147,2018,2,일도1동,여성,1425,37,1462
148,2018,2,일도2동,남성,17177,92,17269
149,2018,2,일도2동,여성,17776,186,17962
150,2018,2,정방동,남성,1264,52,1316
151,2018,2,정방동,여성,1178,49,1227
152,2018,2,조천읍,남성,12102,291,12393
153,2018,2,조천읍,여성,11409,229,11638
154,2018,2,중문동,남성,5573,139,5712
155,2018,2,중문동,여성,5181,143,5324
156,2018,2,중앙동,남성,1893,45,1938
157,2018,2,중앙동,여성,2066,66,2132
158,2018,2,천지동,남성,1806,50,1856
159,2018,2,천지동,여성,1731,47,1778
160,2018,2,추자면,남성,1031,349,1380
161,2018,2,추자면,여성,854,10,864
162,2018,2,표선면,남성,6300,249,6549
163,2018,2,표선면,여성,5984,150,6134
164,2018,2,한경면,남성,4509,215,4724
165,2018,2,한경면,여성,4456,96,4552
166,2018,2,한림읍,남성,10796,2205,13001
167,2018,2,한림읍,여성,10089,1337,11426
168,2018,2,화북동,남성,12517,220,12737
169,2018,2,화북동,여성,12546,146,12692
170,2018,2,효돈동,남성,2686,49,2735
171,2018,2,효돈동,여성,2633,33,2666
172,2018,3,건입동,남성,5072,141,5213
173,2018,3,건입동,여성,4711,81,4792
174,2018,3,구좌읍,남성,8002,376,8378
175,2018,3,구좌읍,여성,7594,176,7770
176,2018,3,남원읍,남성,9837,424,10261
177,2018,3,남원읍,여성,9341,204,9545
178,2018,3,노형동,남성,26225,878,27103
179,2018,3,노형동,여성,27092,805,27897
180,2018,3,대륜동,남성,6921,89,7010
181,2018,3,대륜동,여성,6748,93,6841
182,2018,3,대정읍,남성,10389,824,11213
183,2018,3,대정읍,여성,10782,675,11457
184,2018,3,대천동,남성,6803,104,6907
185,2018,3,대천동,여성,6545,140,6685
186,2018,3,도두동,남성,1614,43,1657
187,2018,3,도두동,여성,1438,55,1493
188,2018,3,동홍동,남성,11156,615,11771
189,2018,3,동홍동,여성,11561,631,12192
190,2018,3,봉개동,남성,2111,34,2145
191,2018,3,봉개동,여성,1868,39,1907
192,2018,3,삼도1동,남성,7042,69,7111
193,2018,3,삼도1동,여성,7338,85,7423
194,2018,3,삼도2동,남성,4480,121,4601
195,2018,3,삼도2동,여성,4195,95,4290
196,2018,3,삼양동,남성,12138,87,12225
197,2018,3,삼양동,여성,11969,161,12130
198,2018,3,서홍동,남성,5328,56,5384
199,2018,3,서홍동,여성,5340,70,5410
200,2018,3,성산읍,남성,8044,991,9035
201,2018,3,성산읍,여성,7368,548,7916
202,2018,3,송산동,남성,2353,367,2720
203,2018,3,송산동,여성,2109,159,2268
204,2018,3,아라동,남성,15638,541,16179
205,2018,3,아라동,여성,15822,550,16372
206,2018,3,안덕면,남성,6003,273,6276
207,2018,3,안덕면,여성,5592,260,5852
208,2018,3,애월읍,남성,17842,535,18377
209,2018,3,애월읍,여성,16649,494,17143
210,2018,3,연동,남성,20484,739,21223
211,2018,3,연동,여성,20950,931,21881
212,2018,3,영천동,남성,2634,110,2744
213,2018,3,영천동,여성,2535,59,2594
214,2018,3,예래동,남성,2039,72,2111
215,2018,3,예래동,여성,1944,68,2012
216,2018,3,오라동,남성,6993,82,7075
217,2018,3,오라동,여성,6842,109,6951
218,2018,3,외도동,남성,10591,116,10707
219,2018,3,외도동,여성,10401,156,10557
220,2018,3,용담1동,남성,3989,38,4027
221,2018,3,용담1동,여성,3753,47,3800
222,2018,3,용담2동,남성,7901,69,7970
223,2018,3,용담2동,여성,7684,137,7821
224,2018,3,우도면,남성,990,17,1007
225,2018,3,우도면,여성,875,15,890
226,2018,3,이도1동,남성,3979,46,4025
227,2018,3,이도1동,여성,3949,77,4026
228,2018,3,이도2동,남성,24400,226,24626
229,2018,3,이도2동,여성,25421,341,25762
230,2018,3,이호동,남성,2198,70,2268
231,2018,3,이호동,여성,2060,74,2134
232,2018,3,일도1동,남성,1561,51,1612
233,2018,3,일도1동,여성,1416,35,1451
234,2018,3,일도2동,남성,17167,88,17255
235,2018,3,일도2동,여성,17793,186,17979
236,2018,3,정방동,남성,1255,55,1310
237,2018,3,정방동,여성,1170,50,1220
238,2018,3,조천읍,남성,12143,295,12438
239,2018,3,조천읍,여성,11440,233,11673
240,2018,3,중문동,남성,5600,140,5740
241,2018,3,중문동,여성,5205,140,5345
242,2018,3,중앙동,남성,1881,45,1926
243,2018,3,중앙동,여성,2054,66,2120
244,2018,3,천지동,남성,1793,50,1843
245,2018,3,천지동,여성,1739,47,1786
246,2018,3,추자면,남성,1015,340,1355
247,2018,3,추자면,여성,843,10,853
248,2018,3,표선면,남성,6301,252,6553
249,2018,3,표선면,여성,5977,151,6128
250,2018,3,한경면,남성,4528,217,4745
251,2018,3,한경면,여성,4471,91,4562
252,2018,3,한림읍,남성,10860,2208,13068
253,2018,3,한림읍,여성,10136,1328,11464
254,2018,3,화북동,남성,12508,217,12725
255,2018,3,화북동,여성,12595,146,12741
256,2018,3,효돈동,남성,2684,48,2732
257,2018,3,효돈동,여성,2634,33,2667
258,2018,4,건입동,남성,5070,143,5213
259,2018,4,건입동,여성,4718,86,4804
260,2018,4,구좌읍,남성,8015,373,8388
261,2018,4,구좌읍,여성,7593,177,7770
262,2018,4,남원읍,남성,9850,428,10278
263,2018,4,남원읍,여성,9353,205,9558
264,2018,4,노형동,남성,26259,941,27200
265,2018,4,노형동,여성,27109,829,27938
266,2018,4,대륜동,남성,6933,89,7022
267,2018,4,대륜동,여성,6754,94,6848
268,2018,4,대정읍,남성,10406,826,11232
269,2018,4,대정읍,여성,10807,681,11488
270,2018,4,대천동,남성,6807,106,6913
271,2018,4,대천동,여성,6544,139,6683
272,2018,4,도두동,남성,1596,43,1639
273,2018,4,도두동,여성,1438,56,1494
274,2018,4,동홍동,남성,11158,614,11772
275,2018,4,동홍동,여성,11563,625,12188
276,2018,4,봉개동,남성,2116,35,2151
277,2018,4,봉개동,여성,1866,40,1906
278,2018,4,삼도1동,남성,7023,77,7100
279,2018,4,삼도1동,여성,7319,94,7413
280,2018,4,삼도2동,남성,4473,131,4604
281,2018,4,삼도2동,여성,4183,97,4280
282,2018,4,삼양동,남성,12157,88,12245
283,2018,4,삼양동,여성,11986,161,12147
284,2018,4,서홍동,남성,5312,56,5368
285,2018,4,서홍동,여성,5332,67,5399
286,2018,4,성산읍,남성,8070,995,9065
287,2018,4,성산읍,여성,7376,553,7929
288,2018,4,송산동,남성,2351,359,2710
289,2018,4,송산동,여성,2102,154,2256
290,2018,4,아라동,남성,15783,533,16316
291,2018,4,아라동,여성,16033,532,16565
292,2018,4,안덕면,남성,6047,279,6326
293,2018,4,안덕면,여성,5630,270,5900
294,2018,4,애월읍,남성,17927,529,18456
295,2018,4,애월읍,여성,16701,484,17185
296,2018,4,연동,남성,20463,754,21217
297,2018,4,연동,여성,20964,934,21898
298,2018,4,영천동,남성,2643,114,2757
299,2018,4,영천동,여성,2544,60,2604
300,2018,4,예래동,남성,2055,73,2128
301,2018,4,예래동,여성,1964,75,2039
302,2018,4,오라동,남성,7048,82,7130
303,2018,4,오라동,여성,6884,109,6993
304,2018,4,외도동,남성,10641,119,10760
305,2018,4,외도동,여성,10400,158,10558
306,2018,4,용담1동,남성,3979,40,4019
307,2018,4,용담1동,여성,3738,44,3782
308,2018,4,용담2동,남성,7893,79,7972
309,2018,4,용담2동,여성,7697,144,7841
310,2018,4,우도면,남성,996,18,1014
311,2018,4,우도면,여성,877,16,893
312,2018,4,이도1동,남성,3977,44,4021
313,2018,4,이도1동,여성,3940,73,4013
314,2018,4,이도2동,남성,24393,230,24623
315,2018,4,이도2동,여성,25420,342,25762
316,2018,4,이호동,남성,2224,67,2291
317,2018,4,이호동,여성,2067,72,2139
318,2018,4,일도1동,남성,1564,49,1613
319,2018,4,일도1동,여성,1419,37,1456
320,2018,4,일도2동,남성,17171,90,17261
321,2018,4,일도2동,여성,17766,186,17952
322,2018,4,정방동,남성,1244,55,1299
323,2018,4,정방동,여성,1173,50,1223
324,2018,4,조천읍,남성,12180,297,12477
325,2018,4,조천읍,여성,11479,241,11720
326,2018,4,중문동,남성,5643,138,5781
327,2018,4,중문동,여성,5230,134,5364
328,2018,4,중앙동,남성,1889,43,1932
329,2018,4,중앙동,여성,2050,66,2116
330,2018,4,천지동,남성,1788,50,1838
331,2018,4,천지동,여성,1742,46,1788
332,2018,4,추자면,남성,1002,334,1336
333,2018,4,추자면,여성,843,10,853
334,2018,4,표선면,남성,6322,249,6571
335,2018,4,표선면,여성,5991,154,6145
336,2018,4,한경면,남성,4546,214,4760
337,2018,4,한경면,여성,4485,92,4577
338,2018,4,한림읍,남성,10868,2213,13081
339,2018,4,한림읍,여성,10168,1357,11525
340,2018,4,화북동,남성,12498,216,12714
341,2018,4,화북동,여성,12571,145,12716
342,2018,4,효돈동,남성,2683,48,2731
343,2018,4,효돈동,여성,2629,34,2663
344,2018,5,건입동,남성,5070,148,5218
345,2018,5,건입동,여성,4730,90,4820
346,2018,5,구좌읍,남성,8021,378,8399
347,2018,5,구좌읍,여성,7624,181,7805
348,2018,5,남원읍,남성,9878,437,10315
349,2018,5,남원읍,여성,9374,201,9575
350,2018,5,노형동,남성,26286,1075,27361
351,2018,5,노형동,여성,27186,898,28084
352,2018,5,대륜동,남성,6954,86,7040
353,2018,5,대륜동,여성,6789,91,6880
354,2018,5,대정읍,남성,10452,840,11292
355,2018,5,대정읍,여성,10840,684,11524
356,2018,5,대천동,남성,6811,101,6912
357,2018,5,대천동,여성,6547,138,6685
358,2018,5,도두동,남성,1586,47,1633
359,2018,5,도두동,여성,1432,66,1498
360,2018,5,동홍동,남성,11162,609,11771
361,2018,5,동홍동,여성,11551,626,12177
362,2018,5,봉개동,남성,2114,38,2152
363,2018,5,봉개동,여성,1865,39,1904
364,2018,5,삼도1동,남성,7001,337,7338
365,2018,5,삼도1동,여성,7306,98,7404
366,2018,5,삼도2동,남성,4451,151,4602
367,2018,5,삼도2동,여성,4166,103,4269
368,2018,5,삼양동,남성,12181,91,12272
369,2018,5,삼양동,여성,12027,156,12183
370,2018,5,서홍동,남성,5309,53,5362
371,2018,5,서홍동,여성,5338,69,5407
372,2018,5,성산읍,남성,8083,1005,9088
373,2018,5,성산읍,여성,7383,553,7936
374,2018,5,송산동,남성,2333,364,2697
375,2018,5,송산동,여성,2092,160,2252
376,2018,5,아라동,남성,15913,538,16451
377,2018,5,아라동,여성,16113,533,16646
378,2018,5,안덕면,남성,6072,282,6354
379,2018,5,안덕면,여성,5648,277,5925
380,2018,5,애월읍,남성,17952,538,18490
381,2018,5,애월읍,여성,16753,500,17253
382,2018,5,연동,남성,20479,763,21242
383,2018,5,연동,여성,20979,942,21921
384,2018,5,영천동,남성,2654,117,2771
385,2018,5,영천동,여성,2551,59,2610
386,2018,5,예래동,남성,2067,81,2148
387,2018,5,예래동,여성,1967,78,2045
388,2018,5,오라동,남성,7086,90,7176
389,2018,5,오라동,여성,6908,108,7016
390,2018,5,외도동,남성,10659,126,10785
391,2018,5,외도동,여성,10412,158,10570
392,2018,5,용담1동,남성,3972,42,4014
393,2018,5,용담1동,여성,3730,44,3774
394,2018,5,용담2동,남성,7905,78,7983
395,2018,5,용담2동,여성,7702,148,7850
396,2018,5,우도면,남성,1001,16,1017
397,2018,5,우도면,여성,877,17,894
398,2018,5,이도1동,남성,3958,45,4003
399,2018,5,이도1동,여성,3949,73,4022
400,2018,5,이도2동,남성,24448,340,24788
401,2018,5,이도2동,여성,25435,354,25789
402,2018,5,이호동,남성,2243,67,2310
403,2018,5,이호동,여성,2077,72,2149
404,2018,5,일도1동,남성,1562,58,1620
405,2018,5,일도1동,여성,1423,38,1461
406,2018,5,일도2동,남성,17140,86,17226
407,2018,5,일도2동,여성,17732,183,17915
408,2018,5,정방동,남성,1242,57,1299
409,2018,5,정방동,여성,1188,49,1237
410,2018,5,조천읍,남성,12215,309,12524
411,2018,5,조천읍,여성,11503,249,11752
412,2018,5,중문동,남성,5660,138,5798
413,2018,5,중문동,여성,5256,139,5395
414,2018,5,중앙동,남성,1890,41,1931
415,2018,5,중앙동,여성,2050,63,2113
416,2018,5,천지동,남성,1806,60,1866
417,2018,5,천지동,여성,1761,44,1805
418,2018,5,추자면,남성,990,324,1314
419,2018,5,추자면,여성,835,11,846
420,2018,5,표선면,남성,6314,257,6571
421,2018,5,표선면,여성,6007,157,6164
422,2018,5,한경면,남성,4574,219,4793
423,2018,5,한경면,여성,4519,94,4613
424,2018,5,한림읍,남성,10898,2235,13133
425,2018,5,한림읍,여성,10214,1368,11582
426,2018,5,화북동,남성,12522,222,12744
427,2018,5,화북동,여성,12561,146,12707
428,2018,5,효돈동,남성,2689,48,2737
429,2018,5,효돈동,여성,2630,35,2665
430,2018,6,건입동,남성,5059,153,5212
431,2018,6,건입동,여성,4723,96,4819
432,2018,6,구좌읍,남성,8038,400,8438
433,2018,6,구좌읍,여성,7634,189,7823
434,2018,6,남원읍,남성,9862,472,10334
435,2018,6,남원읍,여성,9388,208,9596
436,2018,6,노형동,남성,26334,1097,27431
437,2018,6,노형동,여성,27234,915,28149
438,2018,6,대륜동,남성,6960,89,7049
439,2018,6,대륜동,여성,6815,93,6908
440,2018,6,대정읍,남성,10437,868,11305
441,2018,6,대정읍,여성,10810,657,11467
442,2018,6,대천동,남성,6811,101,6912
443,2018,6,대천동,여성,6547,138,6685
444,2018,6,도두동,남성,1593,49,1642
445,2018,6,도두동,여성,1443,65,1508
446,2018,6,동홍동,남성,11182,615,11797
447,2018,6,동홍동,여성,11569,628,12197
448,2018,6,봉개동,남성,2103,40,2143
449,2018,6,봉개동,여성,1871,40,1911
450,2018,6,삼도1동,남성,6994,190,7184
451,2018,6,삼도1동,여성,7285,97,7382
452,2018,6,삼도2동,남성,4444,154,4598
453,2018,6,삼도2동,여성,4157,112,4269
454,2018,6,삼양동,남성,12233,86,12319
455,2018,6,삼양동,여성,12073,154,12227
456,2018,6,서홍동,남성,5300,56,5356
457,2018,6,서홍동,여성,5341,69,5410
458,2018,6,성산읍,남성,8082,1072,9154
459,2018,6,성산읍,여성,7413,566,7979
460,2018,6,송산동,남성,2336,372,2708
461,2018,6,송산동,여성,2084,159,2243
462,2018,6,아라동,남성,16038,534,16572
463,2018,6,아라동,여성,16234,535,16769
464,2018,6,안덕면,남성,6070,291,6361
465,2018,6,안덕면,여성,5645,301,5946
466,2018,6,애월읍,남성,18005,546,18551
467,2018,6,애월읍,여성,16826,485,17311
468,2018,6,연동,남성,20462,761,21223
469,2018,6,연동,여성,20947,944,21891
470,2018,6,영천동,남성,2647,115,2762
471,2018,6,영천동,여성,2553,62,2615
472,2018,6,예래동,남성,2071,94,2165
473,2018,6,예래동,여성,1983,86,2069
474,2018,6,오라동,남성,7205,93,7298
475,2018,6,오라동,여성,7012,113,7125
476,2018,6,외도동,남성,10690,131,10821
477,2018,6,외도동,여성,10455,160,10615
478,2018,6,용담1동,남성,3944,41,3985
479,2018,6,용담1동,여성,3709,43,3752
480,2018,6,용담2동,남성,7894,80,7974
481,2018,6,용담2동,여성,7673,155,7828
482,2018,6,우도면,남성,1007,20,1027
483,2018,6,우도면,여성,878,14,892
484,2018,6,이도1동,남성,3933,49,3982
485,2018,6,이도1동,여성,3947,72,4019
486,2018,6,이도2동,남성,24462,303,24765
487,2018,6,이도2동,여성,25452,360,25812
488,2018,6,이호동,남성,2261,74,2335
489,2018,6,이호동,여성,2093,73,2166
490,2018,6,일도1동,남성,1559,62,1621
491,2018,6,일도1동,여성,1417,34,1451
492,2018,6,일도2동,남성,17112,96,17208
493,2018,6,일도2동,여성,17670,183,17853
494,2018,6,정방동,남성,1238,58,1296
495,2018,6,정방동,여성,1181,48,1229
496,2018,6,조천읍,남성,12242,317,12559
497,2018,6,조천읍,여성,11538,253,11791
498,2018,6,중문동,남성,5693,142,5835
499,2018,6,중문동,여성,5291,149,5440
500,2018,6,중앙동,남성,1885,42,1927
501,2018,6,중앙동,여성,2055,62,2117
502,2018,6,천지동,남성,1800,60,1860
503,2018,6,천지동,여성,1760,45,1805
504,2018,6,추자면,남성,994,332,1326
505,2018,6,추자면,여성,838,12,850
506,2018,6,표선면,남성,6315,265,6580
507,2018,6,표선면,여성,6018,155,6173
508,2018,6,한경면,남성,4574,246,4820
509,2018,6,한경면,여성,4520,97,4617
510,2018,6,한림읍,남성,10884,2320,13204
511,2018,6,한림읍,여성,10217,1347,11564
512,2018,6,화북동,남성,12535,223,12758
513,2018,6,화북동,여성,12556,151,12707
514,2018,6,효돈동,남성,2689,48,2737
515,2018,6,효돈동,여성,2633,33,2666
516,2018,7,건입동,남성,5050,160,5210
517,2018,7,건입동,여성,4725,98,4823
518,2018,7,구좌읍,남성,8054,412,8466
519,2018,7,구좌읍,여성,7661,189,7850
520,2018,7,남원읍,남성,9837,490,10327
521,2018,7,남원읍,여성,9353,210,9563
522,2018,7,노형동,남성,26333,1109,27442
523,2018,7,노형동,여성,27247,929,28176
524,2018,7,대륜동,남성,7002,92,7094
525,2018,7,대륜동,여성,6851,93,6944
526,2018,7,대정읍,남성,10453,866,11319
527,2018,7,대정읍,여성,10827,648,11475
528,2018,7,대천동,남성,6892,108,7000
529,2018,7,대천동,여성,6619,135,6754
530,2018,7,도두동,남성,1606,69,1675
531,2018,7,도두동,여성,1459,67,1526
532,2018,7,동홍동,남성,11204,623,11827
533,2018,7,동홍동,여성,11577,629,12206
534,2018,7,봉개동,남성,2110,39,2149
535,2018,7,봉개동,여성,1893,44,1937
536,2018,7,삼도1동,남성,7012,143,7155
537,2018,7,삼도1동,여성,7269,93,7362
538,2018,7,삼도2동,남성,4436,158,4594
539,2018,7,삼도2동,여성,4131,112,4243
540,2018,7,삼양동,남성,12316,89,12405
541,2018,7,삼양동,여성,12148,153,12301
542,2018,7,서홍동,남성,5291,57,5348
543,2018,7,서홍동,여성,5344,67,5411
544,2018,7,성산읍,남성,8087,1087,9174
545,2018,7,성산읍,여성,7404,572,7976
546,2018,7,송산동,남성,2329,388,2717
547,2018,7,송산동,여성,2080,161,2241
548,2018,7,아라동,남성,16196,533,16729
549,2018,7,아라동,여성,16387,533,16920
550,2018,7,안덕면,남성,6101,304,6405
551,2018,7,안덕면,여성,5645,342,5987
552,2018,7,애월읍,남성,18069,545,18614
553,2018,7,애월읍,여성,16874,490,17364
554,2018,7,연동,남성,20429,769,21198
555,2018,7,연동,여성,21033,952,21985
556,2018,7,영천동,남성,2660,126,2786
557,2018,7,영천동,여성,2561,63,2624
558,2018,7,예래동,남성,2057,118,2175
559,2018,7,예래동,여성,1969,110,2079
560,2018,7,오라동,남성,7246,102,7348
561,2018,7,오라동,여성,7041,115,7156
562,2018,7,외도동,남성,10739,130,10869
563,2018,7,외도동,여성,10493,161,10654
564,2018,7,용담1동,남성,3919,42,3961
565,2018,7,용담1동,여성,3697,45,3742
566,2018,7,용담2동,남성,7891,85,7976
567,2018,7,용담2동,여성,7670,160,7830
568,2018,7,우도면,남성,1002,21,1023
569,2018,7,우도면,여성,886,14,900
570,2018,7,이도1동,남성,3920,50,3970
571,2018,7,이도1동,여성,3955,75,4030
572,2018,7,이도2동,남성,24445,302,24747
573,2018,7,이도2동,여성,25383,352,25735
574,2018,7,이호동,남성,2286,69,2355
575,2018,7,이호동,여성,2109,75,2184
576,2018,7,일도1동,남성,1549,76,1625
577,2018,7,일도1동,여성,1409,39,1448
578,2018,7,일도2동,남성,17060,106,17166
579,2018,7,일도2동,여성,17624,183,17807
580,2018,7,정방동,남성,1219,60,1279
581,2018,7,정방동,여성,1176,49,1225
582,2018,7,조천읍,남성,12305,338,12643
583,2018,7,조천읍,여성,11583,254,11837
584,2018,7,중문동,남성,5735,148,5883
585,2018,7,중문동,여성,5340,146,5486
586,2018,7,중앙동,남성,1883,42,1925
587,2018,7,중앙동,여성,2058,63,2121
588,2018,7,천지동,남성,1802,66,1868
589,2018,7,천지동,여성,1754,43,1797
590,2018,7,추자면,남성,983,328,1311
591,2018,7,추자면,여성,838,12,850
592,2018,7,표선면,남성,6340,271,6611
593,2018,7,표선면,여성,6038,151,6189
594,2018,7,한경면,남성,4562,252,4814
595,2018,7,한경면,여성,4525,100,4625
596,2018,7,한림읍,남성,10895,2321,13216
597,2018,7,한림읍,여성,10231,1342,11573
598,2018,7,화북동,남성,12520,228,12748
599,2018,7,화북동,여성,12553,158,12711
600,2018,7,효돈동,남성,2697,52,2749
601,2018,7,효돈동,여성,2637,31,2668
602,2018,8,건입동,남성,5038,163,5201
603,2018,8,건입동,여성,4718,101,4819
604,2018,8,구좌읍,남성,8037,410,8447
605,2018,8,구좌읍,여성,7640,198,7838
606,2018,8,남원읍,남성,9825,493,10318
607,2018,8,남원읍,여성,9348,211,9559
608,2018,8,노형동,남성,26363,1117,27480
609,2018,8,노형동,여성,27292,923,28215
610,2018,8,대륜동,남성,7002,93,7095
611,2018,8,대륜동,여성,6866,97,6963
612,2018,8,대정읍,남성,10530,956,11486
613,2018,8,대정읍,여성,10929,772,11701
614,2018,8,대천동,남성,6915,104,7019
615,2018,8,대천동,여성,6609,139,6748
616,2018,8,도두동,남성,1615,69,1684
617,2018,8,도두동,여성,1464,62,1526
618,2018,8,동홍동,남성,11217,619,11836
619,2018,8,동홍동,여성,11580,637,12217
620,2018,8,봉개동,남성,2112,40,2152
621,2018,8,봉개동,여성,1904,45,1949
622,2018,8,삼도1동,남성,7014,133,7147
623,2018,8,삼도1동,여성,7265,89,7354
624,2018,8,삼도2동,남성,4415,162,4577
625,2018,8,삼도2동,여성,4095,111,4206
626,2018,8,삼양동,남성,12373,89,12462
627,2018,8,삼양동,여성,12188,158,12346
628,2018,8,서홍동,남성,5294,55,5349
629,2018,8,서홍동,여성,5328,67,5395
630,2018,8,성산읍,남성,8082,1117,9199
631,2018,8,성산읍,여성,7413,583,7996
632,2018,8,송산동,남성,2328,394,2722
633,2018,8,송산동,여성,2080,171,2251
634,2018,8,아라동,남성,16305,530,16835
635,2018,8,아라동,여성,16458,518,16976
636,2018,8,안덕면,남성,6128,318,6446
637,2018,8,안덕면,여성,5675,352,6027
638,2018,8,애월읍,남성,18129,534,18663
639,2018,8,애월읍,여성,16916,480,17396
640,2018,8,연동,남성,20446,785,21231
641,2018,8,연동,여성,21064,946,22010
642,2018,8,영천동,남성,2668,127,2795
643,2018,8,영천동,여성,2574,62,2636
644,2018,8,예래동,남성,2075,125,2200
645,2018,8,예래동,여성,1989,113,2102
646,2018,8,오라동,남성,7280,113,7393
647,2018,8,오라동,여성,7081,113,7194
648,2018,8,외도동,남성,10806,132,10938
649,2018,8,외도동,여성,10561,156,10717
650,2018,8,용담1동,남성,3909,40,3949
651,2018,8,용담1동,여성,3686,46,3732
652,2018,8,용담2동,남성,7879,81,7960
653,2018,8,용담2동,여성,7663,160,7823
654,2018,8,우도면,남성,1000,22,1022
655,2018,8,우도면,여성,879,14,893
656,2018,8,이도1동,남성,3927,53,3980
657,2018,8,이도1동,여성,3956,73,4029
658,2018,8,이도2동,남성,24424,290,24714
659,2018,8,이도2동,여성,25393,357,25750
660,2018,8,이호동,남성,2310,73,2383
661,2018,8,이호동,여성,2134,73,2207
662,2018,8,일도1동,남성,1550,75,1625
663,2018,8,일도1동,여성,1409,38,1447
664,2018,8,일도2동,남성,17078,116,17194
665,2018,8,일도2동,여성,17619,186,17805
666,2018,8,정방동,남성,1212,61,1273
667,2018,8,정방동,여성,1166,49,1215
668,2018,8,조천읍,남성,12334,346,12680
669,2018,8,조천읍,여성,11592,257,11849
670,2018,8,중문동,남성,5731,148,5879
671,2018,8,중문동,여성,5365,153,5518
672,2018,8,중앙동,남성,1872,43,1915
673,2018,8,중앙동,여성,2041,64,2105
674,2018,8,천지동,남성,1803,63,1866
675,2018,8,천지동,여성,1763,47,1810
676,2018,8,추자면,남성,987,334,1321
677,2018,8,추자면,여성,836,13,849
678,2018,8,표선면,남성,6336,271,6607
679,2018,8,표선면,여성,6025,154,6179
680,2018,8,한경면,남성,4564,249,4813
681,2018,8,한경면,여성,4500,103,4603
682,2018,8,한림읍,남성,10930,2351,13281
683,2018,8,한림읍,여성,10260,1344,11604
684,2018,8,화북동,남성,12489,228,12717
685,2018,8,화북동,여성,12521,166,12687
686,2018,8,효돈동,남성,2702,52,2754
687,2018,8,효돈동,여성,2638,32,2670
688,2018,9,건입동,남성,5025,164,5189
689,2018,9,건입동,여성,4704,99,4803
690,2018,9,구좌읍,남성,8043,413,8456
691,2018,9,구좌읍,여성,7642,198,7840
692,2018,9,남원읍,남성,9807,505,10312
693,2018,9,남원읍,여성,9343,219,9562
694,2018,9,노형동,남성,26395,1120,27515
695,2018,9,노형동,여성,27324,920,28244
696,2018,9,대륜동,남성,7010,97,7107
697,2018,9,대륜동,여성,6893,101,6994
698,2018,9,대정읍,남성,10525,950,11475
699,2018,9,대정읍,여성,10919,763,11682
700,2018,9,대천동,남성,6930,109,7039
701,2018,9,대천동,여성,6633,139,6772
702,2018,9,도두동,남성,1615,73,1688
703,2018,9,도두동,여성,1464,61,1525
704,2018,9,동홍동,남성,11236,637,11873
705,2018,9,동홍동,여성,11599,638,12237
706,2018,9,봉개동,남성,2123,41,2164
707,2018,9,봉개동,여성,1918,45,1963
708,2018,9,삼도1동,남성,7021,127,7148
709,2018,9,삼도1동,여성,7278,84,7362
710,2018,9,삼도2동,남성,4405,154,4559
711,2018,9,삼도2동,여성,4079,108,4187
712,2018,9,삼양동,남성,12396,88,12484
713,2018,9,삼양동,여성,12226,160,12386
714,2018,9,서홍동,남성,5287,59,5346
715,2018,9,서홍동,여성,5341,68,5409
716,2018,9,성산읍,남성,8094,1142,9236
717,2018,9,성산읍,여성,7425,589,8014
718,2018,9,송산동,남성,2328,427,2755
719,2018,9,송산동,여성,2076,172,2248
720,2018,9,아라동,남성,16372,588,16960
721,2018,9,아라동,여성,16514,629,17143
722,2018,9,안덕면,남성,6145,328,6473
723,2018,9,안덕면,여성,5726,365,6091
724,2018,9,애월읍,남성,18182,544,18726
725,2018,9,애월읍,여성,16958,498,17456
726,2018,9,연동,남성,20429,784,21213
727,2018,9,연동,여성,21064,942,22006
728,2018,9,영천동,남성,2668,126,2794
729,2018,9,영천동,여성,2575,62,2637
730,2018,9,예래동,남성,2084,132,2216
731,2018,9,예래동,여성,1999,118,2117
732,2018,9,오라동,남성,7312,112,7424
733,2018,9,오라동,여성,7111,113,7224
734,2018,9,외도동,남성,10825,130,10955
735,2018,9,외도동,여성,10590,158,10748
736,2018,9,용담1동,남성,3898,39,3937
737,2018,9,용담1동,여성,3684,42,3726
738,2018,9,용담2동,남성,7878,81,7959
739,2018,9,용담2동,여성,7647,166,7813
740,2018,9,우도면,남성,1002,23,1025
741,2018,9,우도면,여성,878,15,893
742,2018,9,이도1동,남성,3914,53,3967
743,2018,9,이도1동,여성,3958,75,4033
744,2018,9,이도2동,남성,24429,301,24730
745,2018,9,이도2동,여성,25355,370,25725
746,2018,9,이호동,남성,2325,76,2401
747,2018,9,이호동,여성,2160,77,2237
748,2018,9,일도1동,남성,1537,69,1606
749,2018,9,일도1동,여성,1401,39,1440
750,2018,9,일도2동,남성,17058,120,17178
751,2018,9,일도2동,여성,17604,193,17797
752,2018,9,정방동,남성,1200,62,1262
753,2018,9,정방동,여성,1156,49,1205
754,2018,9,조천읍,남성,12362,344,12706
755,2018,9,조천읍,여성,11635,253,11888
756,2018,9,중문동,남성,5747,152,5899
757,2018,9,중문동,여성,5391,156,5547
758,2018,9,중앙동,남성,1878,44,1922
759,2018,9,중앙동,여성,2046,64,2110
760,2018,9,천지동,남성,1801,67,1868
761,2018,9,천지동,여성,1760,52,1812
762,2018,9,추자면,남성,985,338,1323
763,2018,9,추자면,여성,831,13,844
764,2018,9,표선면,남성,6349,268,6617
765,2018,9,표선면,여성,6028,154,6182
766,2018,9,한경면,남성,4559,260,4819
767,2018,9,한경면,여성,4492,105,4597
768,2018,9,한림읍,남성,10944,2377,13321
769,2018,9,한림읍,여성,10253,1339,11592
770,2018,9,화북동,남성,12497,225,12722
771,2018,9,화북동,여성,12516,172,12688
772,2018,9,효돈동,남성,2701,52,2753
773,2018,9,효돈동,여성,2634,30,2664
774,2018,10,건입동,남성,5008,155,5163
775,2018,10,건입동,여성,4694,96,4790
776,2018,10,구좌읍,남성,8020,417,8437
777,2018,10,구좌읍,여성,7649,200,7849
778,2018,10,남원읍,남성,9775,506,10281
779,2018,10,남원읍,여성,9324,226,9550
780,2018,10,노형동,남성,26473,1200,27673
781,2018,10,노형동,여성,27362,973,28335
782,2018,10,대륜동,남성,7018,97,7115
783,2018,10,대륜동,여성,6911,101,7012
784,2018,10,대정읍,남성,10511,951,11462
785,2018,10,대정읍,여성,10902,767,11669
786,2018,10,대천동,남성,6948,111,7059
787,2018,10,대천동,여성,6678,140,6818
788,2018,10,도두동,남성,1633,88,1721
789,2018,10,도두동,여성,1468,64,1532
790,2018,10,동홍동,남성,11236,636,11872
791,2018,10,동홍동,여성,11617,635,12252
792,2018,10,봉개동,남성,2133,39,2172
793,2018,10,봉개동,여성,1927,47,1974
794,2018,10,삼도1동,남성,7007,111,7118
795,2018,10,삼도1동,여성,7270,80,7350
796,2018,10,삼도2동,남성,4393,159,4552
797,2018,10,삼도2동,여성,4055,108,4163
798,2018,10,삼양동,남성,12455,92,12547
799,2018,10,삼양동,여성,12318,165,12483
800,2018,10,서홍동,남성,5294,59,5353
801,2018,10,서홍동,여성,5331,67,5398
802,2018,10,성산읍,남성,8129,1144,9273
803,2018,10,성산읍,여성,7430,591,8021
804,2018,10,송산동,남성,2333,422,2755
805,2018,10,송산동,여성,2079,178,2257
806,2018,10,아라동,남성,16418,606,17024
807,2018,10,아라동,여성,16563,624,17187
808,2018,10,안덕면,남성,6150,330,6480
809,2018,10,안덕면,여성,5721,363,6084
810,2018,10,애월읍,남성,18273,565,18838
811,2018,10,애월읍,여성,17027,529,17556
812,2018,10,연동,남성,20378,792,21170
813,2018,10,연동,여성,21070,959,22029
814,2018,10,영천동,남성,2672,129,2801
815,2018,10,영천동,여성,2583,64,2647
816,2018,10,예래동,남성,2085,141,2226
817,2018,10,예래동,여성,2007,135,2142
818,2018,10,오라동,남성,7363,118,7481
819,2018,10,오라동,여성,7152,116,7268
820,2018,10,외도동,남성,10835,129,10964
821,2018,10,외도동,여성,10605,160,10765
822,2018,10,용담1동,남성,3884,40,3924
823,2018,10,용담1동,여성,3692,45,3737
824,2018,10,용담2동,남성,7882,82,7964
825,2018,10,용담2동,여성,7645,165,7810
826,2018,10,우도면,남성,994,23,1017
827,2018,10,우도면,여성,876,17,893
828,2018,10,이도1동,남성,3901,54,3955
829,2018,10,이도1동,여성,3961,78,4039
830,2018,10,이도2동,남성,24430,312,24742
831,2018,10,이도2동,여성,25302,372,25674
832,2018,10,이호동,남성,2308,76,2384
833,2018,10,이호동,여성,2156,80,2236
834,2018,10,일도1동,남성,1537,71,1608
835,2018,10,일도1동,여성,1388,41,1429
836,2018,10,일도2동,남성,17040,121,17161
837,2018,10,일도2동,여성,17613,189,17802
838,2018,10,정방동,남성,1193,61,1254
839,2018,10,정방동,여성,1154,48,1202
840,2018,10,조천읍,남성,12368,343,12711
841,2018,10,조천읍,여성,11658,256,11914
842,2018,10,중문동,남성,5729,152,5881
843,2018,10,중문동,여성,5396,160,5556
844,2018,10,중앙동,남성,1883,44,1927
845,2018,10,중앙동,여성,2036,61,2097
846,2018,10,천지동,남성,1804,62,1866
847,2018,10,천지동,여성,1766,50,1816
848,2018,10,추자면,남성,980,328,1308
849,2018,10,추자면,여성,830,14,844
850,2018,10,표선면,남성,6367,270,6637
851,2018,10,표선면,여성,6054,165,6219
852,2018,10,한경면,남성,4564,259,4823
853,2018,10,한경면,여성,4510,104,4614
854,2018,10,한림읍,남성,10962,2358,13320
855,2018,10,한림읍,여성,10273,1340,11613
856,2018,10,화북동,남성,12468,227,12695
857,2018,10,화북동,여성,12497,174,12671
858,2018,10,효돈동,남성,2685,53,2738
859,2018,10,효돈동,여성,2617,31,2648
860,2018,11,건입동,남성,4982,153,5135
861,2018,11,건입동,여성,4676,95,4771
862,2018,11,구좌읍,남성,8023,422,8445
863,2018,11,구좌읍,여성,7631,198,7829
864,2018,11,남원읍,남성,9774,501,10275
865,2018,11,남원읍,여성,9320,227,9547
866,2018,11,노형동,남성,26492,1200,27692
867,2018,11,노형동,여성,27410,997,28407
868,2018,11,대륜동,남성,7021,99,7120
869,2018,11,대륜동,여성,6928,100,7028
870,2018,11,대정읍,남성,10491,958,11449
871,2018,11,대정읍,여성,10901,769,11670
872,2018,11,대천동,남성,6950,113,7063
873,2018,11,대천동,여성,6666,143,6809
874,2018,11,도두동,남성,1639,99,1738
875,2018,11,도두동,여성,1466,61,1527
876,2018,11,동홍동,남성,11246,641,11887
877,2018,11,동홍동,여성,11636,641,12277
878,2018,11,봉개동,남성,2258,40,2298
879,2018,11,봉개동,여성,2020,47,2067
880,2018,11,삼도1동,남성,6996,83,7079
881,2018,11,삼도1동,여성,7264,77,7341
882,2018,11,삼도2동,남성,4376,157,4533
883,2018,11,삼도2동,여성,4031,113,4144
884,2018,11,삼양동,남성,12517,85,12602
885,2018,11,삼양동,여성,12386,169,12555
886,2018,11,서홍동,남성,5272,59,5331
887,2018,11,서홍동,여성,5321,69,5390
888,2018,11,성산읍,남성,8101,1137,9238
889,2018,11,성산읍,여성,7418,595,8013
890,2018,11,송산동,남성,2332,431,2763
891,2018,11,송산동,여성,2086,177,2263
892,2018,11,아라동,남성,16484,608,17092
893,2018,11,아라동,여성,16603,630,17233
894,2018,11,안덕면,남성,6169,317,6486
895,2018,11,안덕면,여성,5735,343,6078
896,2018,11,애월읍,남성,18340,554,18894
897,2018,11,애월읍,여성,17062,540,17602
898,2018,11,연동,남성,20384,807,21191
899,2018,11,연동,여성,21059,970,22029
900,2018,11,영천동,남성,2676,126,2802
901,2018,11,영천동,여성,2588,64,2652
902,2018,11,예래동,남성,2103,140,2243
903,2018,11,예래동,여성,2015,139,2154
904,2018,11,오라동,남성,7391,107,7498
905,2018,11,오라동,여성,7204,119,7323
906,2018,11,외도동,남성,10823,125,10948
907,2018,11,외도동,여성,10615,166,10781
908,2018,11,용담1동,남성,3881,40,3921
909,2018,11,용담1동,여성,3681,43,3724
910,2018,11,용담2동,남성,7833,82,7915
911,2018,11,용담2동,여성,7616,166,7782
912,2018,11,우도면,남성,992,22,1014
913,2018,11,우도면,여성,875,18,893
914,2018,11,이도1동,남성,3898,54,3952
915,2018,11,이도1동,여성,3967,83,4050
916,2018,11,이도2동,남성,24381,290,24671
917,2018,11,이도2동,여성,25291,370,25661
918,2018,11,이호동,남성,2311,78,2389
919,2018,11,이호동,여성,2158,82,2240
920,2018,11,일도1동,남성,1522,72,1594
921,2018,11,일도1동,여성,1384,41,1425
922,2018,11,일도2동,남성,16999,107,17106
923,2018,11,일도2동,여성,17587,192,17779
924,2018,11,정방동,남성,1187,64,1251
925,2018,11,정방동,여성,1145,48,1193
926,2018,11,조천읍,남성,12412,336,12748
927,2018,11,조천읍,여성,11676,258,11934
928,2018,11,중문동,남성,5729,153,5882
929,2018,11,중문동,여성,5405,169,5574
930,2018,11,중앙동,남성,1872,46,1918
931,2018,11,중앙동,여성,2029,60,2089
932,2018,11,천지동,남성,1811,63,1874
933,2018,11,천지동,여성,1753,52,1805
934,2018,11,추자면,남성,972,330,1302
935,2018,11,추자면,여성,827,14,841
936,2018,11,표선면,남성,6358,282,6640
937,2018,11,표선면,여성,6031,165,6196
938,2018,11,한경면,남성,4573,254,4827
939,2018,11,한경면,여성,4495,106,4601
940,2018,11,한림읍,남성,10988,2345,13333
941,2018,11,한림읍,여성,10295,1355,11650
942,2018,11,화북동,남성,12454,230,12684
943,2018,11,화북동,여성,12506,179,12685
944,2018,11,효돈동,남성,2683,53,2736
945,2018,11,효돈동,여성,2606,30,2636
946,2018,12,건입동,남성,4951,152,5103
947,2018,12,건입동,여성,4659,95,4754
948,2018,12,구좌읍,남성,8026,418,8444
949,2018,12,구좌읍,여성,7644,195,7839
950,2018,12,남원읍,남성,9751,507,10258
951,2018,12,남원읍,여성,9287,233,9520
952,2018,12,노형동,남성,26551,1210,27761
953,2018,12,노형동,여성,27451,1011,28462
954,2018,12,대륜동,남성,7022,97,7119
955,2018,12,대륜동,여성,6936,101,7037
956,2018,12,대정읍,남성,10468,963,11431
957,2018,12,대정읍,여성,10896,767,11663
958,2018,12,대천동,남성,6984,112,7096
959,2018,12,대천동,여성,6691,143,6834
960,2018,12,도두동,남성,1642,96,1738
961,2018,12,도두동,여성,1459,60,1519
962,2018,12,동홍동,남성,11246,634,11880
963,2018,12,동홍동,여성,11639,644,12283
964,2018,12,봉개동,남성,2538,43,2581
965,2018,12,봉개동,여성,2304,51,2355
966,2018,12,삼도1동,남성,6951,77,7028
967,2018,12,삼도1동,여성,7239,78,7317
968,2018,12,삼도2동,남성,4374,155,4529
969,2018,12,삼도2동,여성,4023,110,4133
970,2018,12,삼양동,남성,12511,89,12600
971,2018,12,삼양동,여성,12386,167,12553
972,2018,12,서홍동,남성,5261,59,5320
973,2018,12,서홍동,여성,5309,68,5377
974,2018,12,성산읍,남성,8083,1129,9212
975,2018,12,성산읍,여성,7367,601,7968
976,2018,12,송산동,남성,2330,434,2764
977,2018,12,송산동,여성,2087,176,2263
978,2018,12,아라동,남성,16475,607,17082
979,2018,12,아라동,여성,16624,615,17239
980,2018,12,안덕면,남성,6138,319,6457
981,2018,12,안덕면,여성,5729,351,6080
982,2018,12,애월읍,남성,18354,548,18902
983,2018,12,애월읍,여성,17097,551,17648
984,2018,12,연동,남성,20352,837,21189
985,2018,12,연동,여성,21045,983,22028
986,2018,12,영천동,남성,2687,124,2811
987,2018,12,영천동,여성,2605,62,2667
988,2018,12,예래동,남성,2114,138,2252
989,2018,12,예래동,여성,2022,140,2162
990,2018,12,오라동,남성,7426,115,7541
991,2018,12,오라동,여성,7247,118,7365
992,2018,12,외도동,남성,10825,127,10952
993,2018,12,외도동,여성,10620,169,10789
994,2018,12,용담1동,남성,3880,39,3919
995,2018,12,용담1동,여성,3647,44,3691
996,2018,12,용담2동,남성,7820,84,7904
997,2018,12,용담2동,여성,7606,163,7769
998,2018,12,우도면,남성,984,21,1005
999,2018,12,우도면,여성,868,19,887
1000,2018,12,이도1동,남성,3884,53,3937
1001,2018,12,이도1동,여성,3967,85,4052
1002,2018,12,이도2동,남성,24256,296,24552
1003,2018,12,이도2동,여성,25200,385,25585
1004,2018,12,이호동,남성,2324,78,2402
1005,2018,12,이호동,여성,2171,81,2252
1006,2018,12,일도1동,남성,1517,66,1583
1007,2018,12,일도1동,여성,1367,43,1410
1008,2018,12,일도2동,남성,16893,103,16996
1009,2018,12,일도2동,여성,17495,193,17688
1010,2018,12,정방동,남성,1189,65,1254
1011,2018,12,정방동,여성,1144,46,1190
1012,2018,12,조천읍,남성,12431,353,12784
1013,2018,12,조천읍,여성,11675,259,11934
1014,2018,12,중문동,남성,5758,150,5908
1015,2018,12,중문동,여성,5401,173,5574
1016,2018,12,중앙동,남성,1855,45,1900
1017,2018,12,중앙동,여성,2024,60,2084
1018,2018,12,천지동,남성,1816,64,1880
1019,2018,12,천지동,여성,1754,54,1808
1020,2018,12,추자면,남성,979,329,1308
1021,2018,12,추자면,여성,825,16,841
1022,2018,12,표선면,남성,6360,287,6647
1023,2018,12,표선면,여성,6014,163,6177
1024,2018,12,한경면,남성,4582,252,4834
1025,2018,12,한경면,여성,4507,106,4613
1026,2018,12,한림읍,남성,10990,2347,13337
1027,2018,12,한림읍,여성,10319,1347,11666
1028,2018,12,화북동,남성,12458,228,12686
1029,2018,12,화북동,여성,12527,178,12705
1030,2018,12,효돈동,남성,2683,57,2740
1031,2018,12,효돈동,여성,2595,30,2625
1032,2019,1,건입동,남성,4896,154,5050
1033,2019,1,건입동,여성,4610,100,4710
1034,2019,1,구좌읍,남성,7996,414,8410
1035,2019,1,구좌읍,여성,7578,196,7774
1036,2019,1,남원읍,남성,9758,511,10269
1037,2019,1,남원읍,여성,9274,250,9524
1038,2019,1,노형동,남성,26493,1230,27723
1039,2019,1,노형동,여성,27468,1022,28490
1040,2019,1,대륜동,남성,7114,99,7213
1041,2019,1,대륜동,여성,7029,111,7140
1042,2019,1,대정읍,남성,10453,976,11429
1043,2019,1,대정읍,여성,10884,770,11654
1044,2019,1,대천동,남성,6976,112,7088
1045,2019,1,대천동,여성,6683,145,6828
1046,2019,1,도두동,남성,1624,96,1720
1047,2019,1,도두동,여성,1452,59,1511
1048,2019,1,동홍동,남성,11246,637,11883
1049,2019,1,동홍동,여성,11638,649,12287
1050,2019,1,봉개동,남성,2614,45,2659
1051,2019,1,봉개동,여성,2383,51,2434
1052,2019,1,삼도1동,남성,6928,77,7005
1053,2019,1,삼도1동,여성,7191,78,7269
1054,2019,1,삼도2동,남성,4376,165,4541
1055,2019,1,삼도2동,여성,4018,117,4135
1056,2019,1,삼양동,남성,12576,85,12661
1057,2019,1,삼양동,여성,12451,170,12621
1058,2019,1,서홍동,남성,5239,58,5297
1059,2019,1,서홍동,여성,5284,66,5350
1060,2019,1,성산읍,남성,8075,1123,9198
1061,2019,1,성산읍,여성,7357,607,7964
1062,2019,1,송산동,남성,2310,424,2734
1063,2019,1,송산동,여성,2073,172,2245
1064,2019,1,아라동,남성,16621,600,17221
1065,2019,1,아라동,여성,16726,607,17333
1066,2019,1,안덕면,남성,6120,321,6441
1067,2019,1,안덕면,여성,5738,344,6082
1068,2019,1,애월읍,남성,18400,615,19015
1069,2019,1,애월읍,여성,17078,553,17631
1070,2019,1,연동,남성,20340,905,21245
1071,2019,1,연동,여성,21078,994,22072
1072,2019,1,영천동,남성,2695,120,2815
1073,2019,1,영천동,여성,2600,62,2662
1074,2019,1,예래동,남성,2115,143,2258
1075,2019,1,예래동,여성,2024,139,2163
1076,2019,1,오라동,남성,7482,122,7604
1077,2019,1,오라동,여성,7298,118,7416
1078,2019,1,외도동,남성,10842,128,10970
1079,2019,1,외도동,여성,10601,171,10772
1080,2019,1,용담1동,남성,3845,39,3884
1081,2019,1,용담1동,여성,3634,45,3679
1082,2019,1,용담2동,남성,7772,85,7857
1083,2019,1,용담2동,여성,7588,175,7763
1084,2019,1,우도면,남성,983,21,1004
1085,2019,1,우도면,여성,872,18,890
1086,2019,1,이도1동,남성,3859,55,3914
1087,2019,1,이도1동,여성,3965,86,4051
1088,2019,1,이도2동,남성,24358,295,24653
1089,2019,1,이도2동,여성,25291,384,25675
1090,2019,1,이호동,남성,2341,76,2417
1091,2019,1,이호동,여성,2183,83,2266
1092,2019,1,일도1동,남성,1511,61,1572
1093,2019,1,일도1동,여성,1359,43,1402
1094,2019,1,일도2동,남성,16802,107,16909
1095,2019,1,일도2동,여성,17388,201,17589
1096,2019,1,정방동,남성,1186,66,1252
1097,2019,1,정방동,여성,1160,46,1206
1098,2019,1,조천읍,남성,12442,359,12801
1099,2019,1,조천읍,여성,11682,261,11943
1100,2019,1,중문동,남성,5757,150,5907
1101,2019,1,중문동,여성,5389,174,5563
1102,2019,1,중앙동,남성,1844,47,1891
1103,2019,1,중앙동,여성,2003,57,2060
1104,2019,1,천지동,남성,1801,63,1864
1105,2019,1,천지동,여성,1749,56,1805
1106,2019,1,추자면,남성,975,319,1294
1107,2019,1,추자면,여성,814,16,830
1108,2019,1,표선면,남성,6344,280,6624
1109,2019,1,표선면,여성,5990,163,6153
1110,2019,1,한경면,남성,4583,252,4835
1111,2019,1,한경면,여성,4503,108,4611
1112,2019,1,한림읍,남성,11011,2343,13354
1113,2019,1,한림읍,여성,10326,1348,11674
1114,2019,1,화북동,남성,12429,229,12658
1115,2019,1,화북동,여성,12514,176,12690
1116,2019,1,효돈동,남성,2681,57,2738
1117,2019,1,효돈동,여성,2598,29,2627
1118,2019,2,건입동,남성,4867,149,5016
1119,2019,2,건입동,여성,4590,107,4697
1120,2019,2,구좌읍,남성,8022,409,8431
1121,2019,2,구좌읍,여성,7611,197,7808
1122,2019,2,남원읍,남성,9763,510,10273
1123,2019,2,남원읍,여성,9257,252,9509
1124,2019,2,노형동,남성,26462,1215,27677
1125,2019,2,노형동,여성,27397,1032,28429
1126,2019,2,대륜동,남성,7177,99,7276
1127,2019,2,대륜동,여성,7089,115,7204
1128,2019,2,대정읍,남성,10466,964,11430
1129,2019,2,대정읍,여성,10883,771,11654
1130,2019,2,대천동,남성,6929,107,7036
1131,2019,2,대천동,여성,6683,145,6828
1132,2019,2,도두동,남성,1636,92,1728
1133,2019,2,도두동,여성,1453,59,1512
1134,2019,2,동홍동,남성,11241,639,11880
1135,2019,2,동홍동,여성,11635,650,12285
1136,2019,2,봉개동,남성,2660,43,2703
1137,2019,2,봉개동,여성,2434,54,2488
1138,2019,2,삼도1동,남성,6897,76,6973
1139,2019,2,삼도1동,여성,7139,78,7217
1140,2019,2,삼도2동,남성,4351,159,4510
1141,2019,2,삼도2동,여성,3994,114,4108
1142,2019,2,삼양동,남성,12578,86,12664
1143,2019,2,삼양동,여성,12465,166,12631
1144,2019,2,서홍동,남성,5216,55,5271
1145,2019,2,서홍동,여성,5284,61,5345
1146,2019,2,성산읍,남성,8109,1117,9226
1147,2019,2,성산읍,여성,7355,612,7967
1148,2019,2,송산동,남성,2309,425,2734
1149,2019,2,송산동,여성,2060,172,2232
1150,2019,2,아라동,남성,16665,581,17246
1151,2019,2,아라동,여성,16828,593,17421
1152,2019,2,안덕면,남성,6100,319,6419
1153,2019,2,안덕면,여성,5735,355,6090
1154,2019,2,애월읍,남성,18425,604,19029
1155,2019,2,애월읍,여성,17165,550,17715
1156,2019,2,연동,남성,20332,928,21260
1157,2019,2,연동,여성,21030,1005,22035
1158,2019,2,영천동,남성,2707,120,2827
1159,2019,2,영천동,여성,2613,65,2678
1160,2019,2,예래동,남성,2116,138,2254
1161,2019,2,예래동,여성,2010,137,2147
1162,2019,2,오라동,남성,7511,121,7632
1163,2019,2,오라동,여성,7308,124,7432
1164,2019,2,외도동,남성,10849,127,10976
1165,2019,2,외도동,여성,10608,171,10779
1166,2019,2,용담1동,남성,3810,39,3849
1167,2019,2,용담1동,여성,3617,46,3663
1168,2019,2,용담2동,남성,7751,85,7836
1169,2019,2,용담2동,여성,7594,176,7770
1170,2019,2,우도면,남성,980,19,999
1171,2019,2,우도면,여성,881,18,899
1172,2019,2,이도1동,남성,3848,55,3903
1173,2019,2,이도1동,여성,3973,84,4057
1174,2019,2,이도2동,남성,24412,290,24702
1175,2019,2,이도2동,여성,25304,391,25695
1176,2019,2,이호동,남성,2331,77,2408
1177,2019,2,이호동,여성,2188,83,2271
1178,2019,2,일도1동,남성,1511,55,1566
1179,2019,2,일도1동,여성,1362,42,1404
1180,2019,2,일도2동,남성,16766,105,16871
1181,2019,2,일도2동,여성,17354,197,17551
1182,2019,2,정방동,남성,1166,67,1233
1183,2019,2,정방동,여성,1155,53,1208
1184,2019,2,조천읍,남성,12498,356,12854
1185,2019,2,조천읍,여성,11730,258,11988
1186,2019,2,중문동,남성,5731,155,5886
1187,2019,2,중문동,여성,5396,171,5567
1188,2019,2,중앙동,남성,1847,48,1895
1189,2019,2,중앙동,여성,2001,53,2054
1190,2019,2,천지동,남성,1816,63,1879
1191,2019,2,천지동,여성,1753,55,1808
1192,2019,2,추자면,남성,965,318,1283
1193,2019,2,추자면,여성,799,15,814
1194,2019,2,표선면,남성,6332,283,6615
1195,2019,2,표선면,여성,5990,161,6151
1196,2019,2,한경면,남성,4584,255,4839
1197,2019,2,한경면,여성,4509,107,4616
1198,2019,2,한림읍,남성,11029,2322,13351
1199,2019,2,한림읍,여성,10327,1348,11675
1200,2019,2,화북동,남성,12413,229,12642
1201,2019,2,화북동,여성,12493,180,12673
1202,2019,2,효돈동,남성,2687,56,2743
1203,2019,2,효돈동,여성,2605,29,2634
1204,2019,3,건입동,남성,4864,147,5011
1205,2019,3,건입동,여성,4592,108,4700
1206,2019,3,구좌읍,남성,8010,419,8429
1207,2019,3,구좌읍,여성,7591,205,7796
1208,2019,3,남원읍,남성,9785,509,10294
1209,2019,3,남원읍,여성,9250,253,9503
1210,2019,3,노형동,남성,26445,1216,27661
1211,2019,3,노형동,여성,27373,1071,28444
1212,2019,3,대륜동,남성,7211,95,7306
1213,2019,3,대륜동,여성,7120,114,7234
1214,2019,3,대정읍,남성,10479,956,11435
1215,2019,3,대정읍,여성,10909,771,11680
1216,2019,3,대천동,남성,6957,101,7058
1217,2019,3,대천동,여성,6695,138,6833
1218,2019,3,도두동,남성,1645,107,1752
1219,2019,3,도두동,여성,1461,60,1521
1220,2019,3,동홍동,남성,11217,644,11861
1221,2019,3,동홍동,여성,11625,652,12277
1222,2019,3,봉개동,남성,2692,42,2734
1223,2019,3,봉개동,여성,2467,56,2523
1224,2019,3,삼도1동,남성,6883,77,6960
1225,2019,3,삼도1동,여성,7135,78,7213
1226,2019,3,삼도2동,남성,4328,159,4487
1227,2019,3,삼도2동,여성,3991,108,4099
1228,2019,3,삼양동,남성,12604,87,12691
1229,2019,3,삼양동,여성,12504,167,12671
1230,2019,3,서홍동,남성,5200,52,5252
1231,2019,3,서홍동,여성,5274,62,5336
1232,2019,3,성산읍,남성,8126,1092,9218
1233,2019,3,성산읍,여성,7369,614,7983
1234,2019,3,송산동,남성,2296,413,2709
1235,2019,3,송산동,여성,2039,172,2211
1236,2019,3,아라동,남성,16694,649,17343
1237,2019,3,아라동,여성,16872,657,17529
1238,2019,3,안덕면,남성,6094,315,6409
1239,2019,3,안덕면,여성,5730,349,6079
1240,2019,3,애월읍,남성,18517,596,19113
1241,2019,3,애월읍,여성,17217,519,17736
1242,2019,3,연동,남성,20398,946,21344
1243,2019,3,연동,여성,21030,1058,22088
1244,2019,3,영천동,남성,2720,118,2838
1245,2019,3,영천동,여성,2611,64,2675
1246,2019,3,예래동,남성,2123,145,2268
1247,2019,3,예래동,여성,1999,139,2138
1248,2019,3,오라동,남성,7558,110,7668
1249,2019,3,오라동,여성,7344,127,7471
1250,2019,3,외도동,남성,10853,130,10983
1251,2019,3,외도동,여성,10621,174,10795
1252,2019,3,용담1동,남성,3805,38,3843
1253,2019,3,용담1동,여성,3609,48,3657
1254,2019,3,용담2동,남성,7726,82,7808
1255,2019,3,용담2동,여성,7577,180,7757
1256,2019,3,우도면,남성,978,18,996
1257,2019,3,우도면,여성,877,19,896
1258,2019,3,이도1동,남성,3822,55,3877
1259,2019,3,이도1동,여성,3939,83,4022
1260,2019,3,이도2동,남성,24438,292,24730
1261,2019,3,이도2동,여성,25331,395,25726
1262,2019,3,이호동,남성,2337,77,2414
1263,2019,3,이호동,여성,2200,84,2284
1264,2019,3,일도1동,남성,1501,57,1558
1265,2019,3,일도1동,여성,1369,41,1410
1266,2019,3,일도2동,남성,16753,95,16848
1267,2019,3,일도2동,여성,17321,199,17520
1268,2019,3,정방동,남성,1172,63,1235
1269,2019,3,정방동,여성,1156,52,1208
1270,2019,3,조천읍,남성,12527,350,12877
1271,2019,3,조천읍,여성,11785,258,12043
1272,2019,3,중문동,남성,5738,160,5898
1273,2019,3,중문동,여성,5403,172,5575
1274,2019,3,중앙동,남성,1844,48,1892
1275,2019,3,중앙동,여성,1999,53,2052
1276,2019,3,천지동,남성,1827,63,1890
1277,2019,3,천지동,여성,1762,54,1816
1278,2019,3,추자면,남성,958,310,1268
1279,2019,3,추자면,여성,798,15,813
1280,2019,3,표선면,남성,6344,283,6627
1281,2019,3,표선면,여성,5984,158,6142
1282,2019,3,한경면,남성,4597,252,4849
1283,2019,3,한경면,여성,4525,110,4635
1284,2019,3,한림읍,남성,11037,2300,13337
1285,2019,3,한림읍,여성,10339,1349,11688
1286,2019,3,화북동,남성,12427,236,12663
1287,2019,3,화북동,여성,12491,186,12677
1288,2019,3,효돈동,남성,2696,55,2751
1289,2019,3,효돈동,여성,2610,29,2639
1290,2019,4,건입동,남성,4867,152,5019
1291,2019,4,건입동,여성,4596,102,4698
1292,2019,4,구좌읍,남성,8007,451,8458
1293,2019,4,구좌읍,여성,7620,211,7831
1294,2019,4,남원읍,남성,9818,512,10330
1295,2019,4,남원읍,여성,9268,258,9526
1296,2019,4,노형동,남성,26423,1385,27808
1297,2019,4,노형동,여성,27349,1119,28468
1298,2019,4,대륜동,남성,7206,94,7300
1299,2019,4,대륜동,여성,7141,115,7256
1300,2019,4,대정읍,남성,10484,962,11446
1301,2019,4,대정읍,여성,10941,768,11709
1302,2019,4,대천동,남성,6950,98,7048
1303,2019,4,대천동,여성,6699,136,6835
1304,2019,4,도두동,남성,1647,106,1753
1305,2019,4,도두동,여성,1466,60,1526
1306,2019,4,동홍동,남성,11216,639,11855
1307,2019,4,동홍동,여성,11611,655,12266
1308,2019,4,봉개동,남성,2699,46,2745
1309,2019,4,봉개동,여성,2482,56,2538
1310,2019,4,삼도1동,남성,6875,73,6948
1311,2019,4,삼도1동,여성,7134,78,7212
1312,2019,4,삼도2동,남성,4293,169,4462
1313,2019,4,삼도2동,여성,3971,112,4083
1314,2019,4,삼양동,남성,12634,90,12724
1315,2019,4,삼양동,여성,12526,165,12691
1316,2019,4,서홍동,남성,5206,55,5261
1317,2019,4,서홍동,여성,5265,64,5329
1318,2019,4,성산읍,남성,8119,1112,9231
1319,2019,4,성산읍,여성,7385,612,7997
1320,2019,4,송산동,남성,2301,410,2711
1321,2019,4,송산동,여성,2033,171,2204
1322,2019,4,아라동,남성,16756,633,17389
1323,2019,4,아라동,여성,16931,643,17574
1324,2019,4,안덕면,남성,6112,316,6428
1325,2019,4,안덕면,여성,5727,376,6103
1326,2019,4,애월읍,남성,18541,580,19121
1327,2019,4,애월읍,여성,17255,526,17781
1328,2019,4,연동,남성,20416,939,21355
1329,2019,4,연동,여성,21043,1039,22082
1330,2019,4,영천동,남성,2716,119,2835
1331,2019,4,영천동,여성,2616,62,2678
1332,2019,4,예래동,남성,2108,143,2251
1333,2019,4,예래동,여성,1991,140,2131
1334,2019,4,오라동,남성,7622,110,7732
1335,2019,4,오라동,여성,7420,130,7550
1336,2019,4,외도동,남성,10856,130,10986
1337,2019,4,외도동,여성,10639,169,10808
1338,2019,4,용담1동,남성,3796,39,3835
1339,2019,4,용담1동,여성,3600,53,3653
1340,2019,4,용담2동,남성,7701,81,7782
1341,2019,4,용담2동,여성,7577,184,7761
1342,2019,4,우도면,남성,983,20,1003
1343,2019,4,우도면,여성,884,18,902
1344,2019,4,이도1동,남성,3786,54,3840
1345,2019,4,이도1동,여성,3930,85,4015
1346,2019,4,이도2동,남성,24485,290,24775
1347,2019,4,이도2동,여성,25366,385,25751
1348,2019,4,이호동,남성,2339,80,2419
1349,2019,4,이호동,여성,2212,84,2296
1350,2019,4,일도1동,남성,1493,53,1546
1351,2019,4,일도1동,여성,1356,43,1399
1352,2019,4,일도2동,남성,16762,98,16860
1353,2019,4,일도2동,여성,17270,210,17480
1354,2019,4,정방동,남성,1168,63,1231
1355,2019,4,정방동,여성,1153,52,1205
1356,2019,4,조천읍,남성,12531,340,12871
1357,2019,4,조천읍,여성,11815,263,12078
1358,2019,4,중문동,남성,5745,163,5908
1359,2019,4,중문동,여성,5421,170,5591
1360,2019,4,중앙동,남성,1848,49,1897
1361,2019,4,중앙동,여성,1997,53,2050
1362,2019,4,천지동,남성,1849,60,1909
1363,2019,4,천지동,여성,1772,57,1829
1364,2019,4,추자면,남성,961,303,1264
1365,2019,4,추자면,여성,798,14,812
1366,2019,4,표선면,남성,6359,281,6640
1367,2019,4,표선면,여성,5988,153,6141
1368,2019,4,한경면,남성,4605,257,4862
1369,2019,4,한경면,여성,4529,110,4639
1370,2019,4,한림읍,남성,11048,2301,13349
1371,2019,4,한림읍,여성,10363,1349,11712
1372,2019,4,화북동,남성,12417,236,12653
1373,2019,4,화북동,여성,12468,189,12657
1374,2019,4,효돈동,남성,2681,50,2731
1375,2019,4,효돈동,여성,2611,28,2639
1376,2019,5,건입동,남성,4853,150,5003
1377,2019,5,건입동,여성,4566,104,4670
1378,2019,5,구좌읍,남성,8017,450,8467
1379,2019,5,구좌읍,여성,7624,215,7839
1380,2019,5,남원읍,남성,9840,508,10348
1381,2019,5,남원읍,여성,9286,262,9548
1382,2019,5,노형동,남성,26454,1394,27848
1383,2019,5,노형동,여성,27351,1120,28471
1384,2019,5,대륜동,남성,7221,94,7315
1385,2019,5,대륜동,여성,7143,116,7259
1386,2019,5,대정읍,남성,10466,959,11425
1387,2019,5,대정읍,여성,10949,762,11711
1388,2019,5,대천동,남성,6939,98,7037
1389,2019,5,대천동,여성,6720,129,6849
1390,2019,5,도두동,남성,1646,104,1750
1391,2019,5,도두동,여성,1471,58,1529
1392,2019,5,동홍동,남성,11224,632,11856
1393,2019,5,동홍동,여성,11641,654,12295
1394,2019,5,봉개동,남성,2715,45,2760
1395,2019,5,봉개동,여성,2489,57,2546
1396,2019,5,삼도1동,남성,6857,69,6926
1397,2019,5,삼도1동,여성,7124,77,7201
1398,2019,5,삼도2동,남성,4288,168,4456
1399,2019,5,삼도2동,여성,3966,107,4073
1400,2019,5,삼양동,남성,12676,87,12763
1401,2019,5,삼양동,여성,12534,162,12696
1402,2019,5,서홍동,남성,5202,62,5264
1403,2019,5,서홍동,여성,5276,65,5341
1404,2019,5,성산읍,남성,8105,1138,9243
1405,2019,5,성산읍,여성,7379,615,7994
1406,2019,5,송산동,남성,2295,407,2702
1407,2019,5,송산동,여성,2026,168,2194
1408,2019,5,아라동,남성,16823,626,17449
1409,2019,5,아라동,여성,16976,634,17610
1410,2019,5,안덕면,남성,6116,324,6440
1411,2019,5,안덕면,여성,5751,376,6127
1412,2019,5,애월읍,남성,18585,582,19167
1413,2019,5,애월읍,여성,17333,519,17852
1414,2019,5,연동,남성,20435,936,21371
1415,2019,5,연동,여성,21068,1041,22109
1416,2019,5,영천동,남성,2724,121,2845
1417,2019,5,영천동,여성,2618,63,2681
1418,2019,5,예래동,남성,2103,140,2243
1419,2019,5,예래동,여성,1981,140,2121
1420,2019,5,오라동,남성,7662,116,7778
1421,2019,5,오라동,여성,7480,127,7607
1422,2019,5,외도동,남성,10864,129,10993
1423,2019,5,외도동,여성,10664,169,10833
1424,2019,5,용담1동,남성,3785,37,3822
1425,2019,5,용담1동,여성,3575,51,3626
1426,2019,5,용담2동,남성,7701,81,7782
1427,2019,5,용담2동,여성,7576,185,7761
1428,2019,5,우도면,남성,990,18,1008
1429,2019,5,우도면,여성,886,18,904
1430,2019,5,이도1동,남성,3780,53,3833
1431,2019,5,이도1동,여성,3923,84,4007
1432,2019,5,이도2동,남성,24542,285,24827
1433,2019,5,이도2동,여성,25403,382,25785
1434,2019,5,이호동,남성,2350,82,2432
1435,2019,5,이호동,여성,2219,86,2305
1436,2019,5,일도1동,남성,1487,55,1542
1437,2019,5,일도1동,여성,1345,41,1386
1438,2019,5,일도2동,남성,16749,99,16848
1439,2019,5,일도2동,여성,17253,211,17464
1440,2019,5,정방동,남성,1181,61,1242
1441,2019,5,정방동,여성,1149,52,1201
1442,2019,5,조천읍,남성,12522,339,12861
1443,2019,5,조천읍,여성,11856,258,12114
1444,2019,5,중문동,남성,5768,162,5930
1445,2019,5,중문동,여성,5452,173,5625
1446,2019,5,중앙동,남성,1826,52,1878
1447,2019,5,중앙동,여성,1985,53,2038
1448,2019,5,천지동,남성,1837,59,1896
1449,2019,5,천지동,여성,1778,56,1834
1450,2019,5,추자면,남성,958,303,1261
1451,2019,5,추자면,여성,792,15,807
1452,2019,5,표선면,남성,6367,281,6648
1453,2019,5,표선면,여성,5998,151,6149
1454,2019,5,한경면,남성,4591,249,4840
1455,2019,5,한경면,여성,4510,111,4621
1456,2019,5,한림읍,남성,11052,2321,13373
1457,2019,5,한림읍,여성,10389,1347,11736
1458,2019,5,화북동,남성,12444,231,12675
1459,2019,5,화북동,여성,12498,195,12693
1460,2019,5,효돈동,남성,2677,54,2731
1461,2019,5,효돈동,여성,2608,28,2636
1462,2019,6,건입동,남성,4853,155,5008
1463,2019,6,건입동,여성,4564,104,4668
1464,2019,6,구좌읍,남성,8016,451,8467
1465,2019,6,구좌읍,여성,7634,210,7844
1466,2019,6,남원읍,남성,9847,525,10372
1467,2019,6,남원읍,여성,9278,265,9543
1468,2019,6,노형동,남성,26444,1393,27837
1469,2019,6,노형동,여성,27356,1117,28473
1470,2019,6,대륜동,남성,7232,95,7327
1471,2019,6,대륜동,여성,7105,120,7225
1472,2019,6,대정읍,남성,10436,919,11355
1473,2019,6,대정읍,여성,10898,711,11609
1474,2019,6,대천동,남성,6988,100,7088
1475,2019,6,대천동,여성,6734,128,6862
1476,2019,6,도두동,남성,1649,107,1756
1477,2019,6,도두동,여성,1477,65,1542
1478,2019,6,동홍동,남성,11222,638,11860
1479,2019,6,동홍동,여성,11670,655,12325
1480,2019,6,봉개동,남성,2722,42,2764
1481,2019,6,봉개동,여성,2503,55,2558
1482,2019,6,삼도1동,남성,6837,72,6909
1483,2019,6,삼도1동,여성,7110,77,7187
1484,2019,6,삼도2동,남성,4282,166,4448
1485,2019,6,삼도2동,여성,3957,105,4062
1486,2019,6,삼양동,남성,12732,89,12821
1487,2019,6,삼양동,여성,12600,159,12759
1488,2019,6,서홍동,남성,5197,64,5261
1489,2019,6,서홍동,여성,5303,60,5363
1490,2019,6,성산읍,남성,8118,1152,9270
1491,2019,6,성산읍,여성,7381,615,7996
1492,2019,6,송산동,남성,2285,421,2706
1493,2019,6,송산동,여성,2027,168,2195
1494,2019,6,아라동,남성,16865,620,17485
1495,2019,6,아라동,여성,17023,625,17648
1496,2019,6,안덕면,남성,6136,340,6476
1497,2019,6,안덕면,여성,5752,385,6137
1498,2019,6,애월읍,남성,18666,572,19238
1499,2019,6,애월읍,여성,17380,498,17878
1500,2019,6,연동,남성,20421,950,21371
1501,2019,6,연동,여성,21058,1053,22111
1502,2019,6,영천동,남성,2746,122,2868
1503,2019,6,영천동,여성,2630,67,2697
1504,2019,6,예래동,남성,2091,133,2224
1505,2019,6,예래동,여성,1975,143,2118
1506,2019,6,오라동,남성,7685,115,7800
1507,2019,6,오라동,여성,7506,130,7636
1508,2019,6,외도동,남성,10879,129,11008
1509,2019,6,외도동,여성,10692,163,10855
1510,2019,6,용담1동,남성,3780,35,3815
1511,2019,6,용담1동,여성,3558,50,3608
1512,2019,6,용담2동,남성,7690,82,7772
1513,2019,6,용담2동,여성,7570,181,7751
1514,2019,6,우도면,남성,980,20,1000
1515,2019,6,우도면,여성,889,17,906
1516,2019,6,이도1동,남성,3773,57,3830
1517,2019,6,이도1동,여성,3921,81,4002
1518,2019,6,이도2동,남성,24537,284,24821
1519,2019,6,이도2동,여성,25445,389,25834
1520,2019,6,이호동,남성,2339,83,2422
1521,2019,6,이호동,여성,2217,85,2302
1522,2019,6,일도1동,남성,1480,56,1536
1523,2019,6,일도1동,여성,1337,40,1377
1524,2019,6,일도2동,남성,16754,92,16846
1525,2019,6,일도2동,여성,17228,209,17437
1526,2019,6,정방동,남성,1178,63,1241
1527,2019,6,정방동,여성,1156,51,1207
1528,2019,6,조천읍,남성,12534,341,12875
1529,2019,6,조천읍,여성,11883,252,12135
1530,2019,6,중문동,남성,5787,166,5953
1531,2019,6,중문동,여성,5457,173,5630
1532,2019,6,중앙동,남성,1821,51,1872
1533,2019,6,중앙동,여성,1984,49,2033
1534,2019,6,천지동,남성,1830,64,1894
1535,2019,6,천지동,여성,1770,57,1827
1536,2019,6,추자면,남성,951,313,1264
1537,2019,6,추자면,여성,790,15,805
1538,2019,6,표선면,남성,6367,281,6648
1539,2019,6,표선면,여성,6011,149,6160
1540,2019,6,한경면,남성,4606,251,4857
1541,2019,6,한경면,여성,4510,109,4619
1542,2019,6,한림읍,남성,11041,2320,13361
1543,2019,6,한림읍,여성,10401,1355,11756
1544,2019,6,화북동,남성,12464,232,12696
1545,2019,6,화북동,여성,12483,190,12673
1546,2019,6,효돈동,남성,2683,54,2737
1547,2019,6,효돈동,여성,2604,29,2633
1548,2019,7,건입동,남성,4851,157,5008
1549,2019,7,건입동,여성,4557,103,4660
1550,2019,7,구좌읍,남성,8016,460,8476
1551,2019,7,구좌읍,여성,7626,209,7835
1552,2019,7,남원읍,남성,9833,527,10360
1553,2019,7,남원읍,여성,9265,273,9538
1554,2019,7,노형동,남성,26464,1346,27810
1555,2019,7,노형동,여성,27366,1092,28458
1556,2019,7,대륜동,남성,7235,96,7331
1557,2019,7,대륜동,여성,7121,117,7238
1558,2019,7,대정읍,남성,10440,918,11358
1559,2019,7,대정읍,여성,10892,694,11586
1560,2019,7,대천동,남성,6970,101,7071
1561,2019,7,대천동,여성,6754,131,6885
1562,2019,7,도두동,남성,1646,96,1742
1563,2019,7,도두동,여성,1474,61,1535
1564,2019,7,동홍동,남성,11217,629,11846
1565,2019,7,동홍동,여성,11667,646,12313
1566,2019,7,봉개동,남성,2712,43,2755
1567,2019,7,봉개동,여성,2497,51,2548
1568,2019,7,삼도1동,남성,6850,70,6920
1569,2019,7,삼도1동,여성,7132,78,7210
1570,2019,7,삼도2동,남성,4275,162,4437
1571,2019,7,삼도2동,여성,3953,101,4054
1572,2019,7,삼양동,남성,12766,92,12858
1573,2019,7,삼양동,여성,12632,156,12788
1574,2019,7,서홍동,남성,5196,63,5259
1575,2019,7,서홍동,여성,5309,58,5367
1576,2019,7,성산읍,남성,8131,1172,9303
1577,2019,7,성산읍,여성,7414,610,8024
1578,2019,7,송산동,남성,2274,427,2701
1579,2019,7,송산동,여성,2013,171,2184
1580,2019,7,아라동,남성,16971,629,17600
1581,2019,7,아라동,여성,17066,610,17676
1582,2019,7,안덕면,남성,6146,349,6495
1583,2019,7,안덕면,여성,5763,395,6158
1584,2019,7,애월읍,남성,18663,572,19235
1585,2019,7,애월읍,여성,17388,496,17884
1586,2019,7,연동,남성,20403,1018,21421
1587,2019,7,연동,여성,21110,1095,22205
1588,2019,7,영천동,남성,2751,121,2872
1589,2019,7,영천동,여성,2634,68,2702
1590,2019,7,예래동,남성,2092,136,2228
1591,2019,7,예래동,여성,1977,147,2124
1592,2019,7,오라동,남성,7671,119,7790
1593,2019,7,오라동,여성,7520,129,7649
1594,2019,7,외도동,남성,10904,128,11032
1595,2019,7,외도동,여성,10725,166,10891
1596,2019,7,용담1동,남성,3772,35,3807
1597,2019,7,용담1동,여성,3562,50,3612
1598,2019,7,용담2동,남성,7689,80,7769
1599,2019,7,용담2동,여성,7566,178,7744
1600,2019,7,우도면,남성,984,20,1004
1601,2019,7,우도면,여성,887,14,901
1602,2019,7,이도1동,남성,3780,60,3840
1603,2019,7,이도1동,여성,3910,84,3994
1604,2019,7,이도2동,남성,24576,283,24859
1605,2019,7,이도2동,여성,25462,375,25837
1606,2019,7,이호동,남성,2353,82,2435
1607,2019,7,이호동,여성,2216,86,2302
1608,2019,7,일도1동,남성,1473,52,1525
1609,2019,7,일도1동,여성,1331,41,1372
1610,2019,7,일도2동,남성,16730,97,16827
1611,2019,7,일도2동,여성,17235,211,17446
1612,2019,7,정방동,남성,1167,62,1229
1613,2019,7,정방동,여성,1157,53,1210
1614,2019,7,조천읍,남성,12559,343,12902
1615,2019,7,조천읍,여성,11909,252,12161
1616,2019,7,중문동,남성,5803,165,5968
1617,2019,7,중문동,여성,5476,165,5641
1618,2019,7,중앙동,남성,1816,50,1866
1619,2019,7,중앙동,여성,1986,50,2036
1620,2019,7,천지동,남성,1832,63,1895
1621,2019,7,천지동,여성,1768,56,1824
1622,2019,7,추자면,남성,949,313,1262
1623,2019,7,추자면,여성,789,14,803
1624,2019,7,표선면,남성,6368,281,6649
1625,2019,7,표선면,여성,6001,149,6150
1626,2019,7,한경면,남성,4603,250,4853
1627,2019,7,한경면,여성,4515,110,4625
1628,2019,7,한림읍,남성,11023,2319,13342
1629,2019,7,한림읍,여성,10377,1356,11733
1630,2019,7,화북동,남성,12471,232,12703
1631,2019,7,화북동,여성,12488,188,12676
1632,2019,7,효돈동,남성,2683,51,2734
1633,2019,7,효돈동,여성,2611,28,2639
1634,2019,8,건입동,남성,4828,158,4986
1635,2019,8,건입동,여성,4552,102,4654
1636,2019,8,구좌읍,남성,8026,461,8487
1637,2019,8,구좌읍,여성,7635,209,7844
1638,2019,8,남원읍,남성,9828,525,10353
1639,2019,8,남원읍,여성,9281,274,9555
1640,2019,8,노형동,남성,26509,1312,27821
1641,2019,8,노형동,여성,27444,1068,28512
1642,2019,8,대륜동,남성,7240,96,7336
1643,2019,8,대륜동,여성,7106,118,7224
1644,2019,8,대정읍,남성,10443,1007,11450
1645,2019,8,대정읍,여성,10965,806,11771
1646,2019,8,대천동,남성,6982,105,7087
1647,2019,8,대천동,여성,6776,129,6905
1648,2019,8,도두동,남성,1665,93,1758
1649,2019,8,도두동,여성,1485,60,1545
1650,2019,8,동홍동,남성,11247,630,11877
1651,2019,8,동홍동,여성,11701,649,12350
1652,2019,8,봉개동,남성,2714,40,2754
1653,2019,8,봉개동,여성,2502,50,2552
1654,2019,8,삼도1동,남성,6827,69,6896
1655,2019,8,삼도1동,여성,7124,80,7204
1656,2019,8,삼도2동,남성,4259,165,4424
1657,2019,8,삼도2동,여성,3937,101,4038
1658,2019,8,삼양동,남성,12808,96,12904
1659,2019,8,삼양동,여성,12639,160,12799
1660,2019,8,서홍동,남성,5190,61,5251
1661,2019,8,서홍동,여성,5299,57,5356
1662,2019,8,성산읍,남성,8163,1159,9322
1663,2019,8,성산읍,여성,7434,613,8047
1664,2019,8,송산동,남성,2271,438,2709
1665,2019,8,송산동,여성,2020,168,2188
1666,2019,8,아라동,남성,17066,631,17697
1667,2019,8,아라동,여성,17129,601,17730
1668,2019,8,안덕면,남성,6170,349,6519
1669,2019,8,안덕면,여성,5782,397,6179
1670,2019,8,애월읍,남성,18666,572,19238
1671,2019,8,애월읍,여성,17390,499,17889
1672,2019,8,연동,남성,20402,1045,21447
1673,2019,8,연동,여성,21120,1118,22238
1674,2019,8,영천동,남성,2757,122,2879
1675,2019,8,영천동,여성,2628,68,2696
1676,2019,8,예래동,남성,2079,137,2216
1677,2019,8,예래동,여성,1968,147,2115
1678,2019,8,오라동,남성,7702,125,7827
1679,2019,8,오라동,여성,7533,127,7660
1680,2019,8,외도동,남성,10911,127,11038
1681,2019,8,외도동,여성,10752,169,10921
1682,2019,8,용담1동,남성,3767,33,3800
1683,2019,8,용담1동,여성,3554,52,3606
1684,2019,8,용담2동,남성,7683,78,7761
1685,2019,8,용담2동,여성,7555,181,7736
1686,2019,8,우도면,남성,992,21,1013
1687,2019,8,우도면,여성,897,14,911
1688,2019,8,이도1동,남성,3772,59,3831
1689,2019,8,이도1동,여성,3883,85,3968
1690,2019,8,이도2동,남성,24598,292,24890
1691,2019,8,이도2동,여성,25462,382,25844
1692,2019,8,이호동,남성,2362,88,2450
1693,2019,8,이호동,여성,2214,87,2301
1694,2019,8,일도1동,남성,1456,51,1507
1695,2019,8,일도1동,여성,1318,39,1357
1696,2019,8,일도2동,남성,16694,98,16792
1697,2019,8,일도2동,여성,17184,217,17401
1698,2019,8,정방동,남성,1159,66,1225
1699,2019,8,정방동,여성,1145,54,1199
1700,2019,8,조천읍,남성,12552,337,12889
1701,2019,8,조천읍,여성,11904,250,12154
1702,2019,8,중문동,남성,5785,166,5951
1703,2019,8,중문동,여성,5476,167,5643
1704,2019,8,중앙동,남성,1802,51,1853
1705,2019,8,중앙동,여성,1976,52,2028
1706,2019,8,천지동,남성,1816,64,1880
1707,2019,8,천지동,여성,1764,56,1820
1708,2019,8,추자면,남성,946,311,1257
1709,2019,8,추자면,여성,791,14,805
1710,2019,8,표선면,남성,6342,282,6624
1711,2019,8,표선면,여성,5993,146,6139
1712,2019,8,한경면,남성,4589,250,4839
1713,2019,8,한경면,여성,4509,110,4619
1714,2019,8,한림읍,남성,11021,2343,13364
1715,2019,8,한림읍,여성,10398,1351,11749
1716,2019,8,화북동,남성,12429,227,12656
1717,2019,8,화북동,여성,12477,188,12665
1718,2019,8,효돈동,남성,2688,52,2740
1719,2019,8,효돈동,여성,2613,29,2642
1720,2019,9,건입동,남성,4819,161,4980
1721,2019,9,건입동,여성,4561,102,4663
1722,2019,9,구좌읍,남성,8028,463,8491
1723,2019,9,구좌읍,여성,7623,209,7832
1724,2019,9,남원읍,남성,9794,532,10326
1725,2019,9,남원읍,여성,9255,279,9534
1726,2019,9,노형동,남성,26514,1373,27887
1727,2019,9,노형동,여성,27439,1090,28529
1728,2019,9,대륜동,남성,7241,101,7342
1729,2019,9,대륜동,여성,7112,125,7237
1730,2019,9,대정읍,남성,10437,991,11428
1731,2019,9,대정읍,여성,10942,792,11734
1732,2019,9,대천동,남성,6998,104,7102
1733,2019,9,대천동,여성,6802,130,6932
1734,2019,9,도두동,남성,1666,85,1751
1735,2019,9,도두동,여성,1485,60,1545
1736,2019,9,동홍동,남성,11287,630,11917
1737,2019,9,동홍동,여성,11736,648,12384
1738,2019,9,봉개동,남성,2726,41,2767
1739,2019,9,봉개동,여성,2510,51,2561
1740,2019,9,삼도1동,남성,6826,69,6895
1741,2019,9,삼도1동,여성,7098,83,7181
1742,2019,9,삼도2동,남성,4268,159,4427
1743,2019,9,삼도2동,여성,3946,97,4043
1744,2019,9,삼양동,남성,12812,97,12909
1745,2019,9,삼양동,여성,12649,162,12811
1746,2019,9,서홍동,남성,5168,63,5231
1747,2019,9,서홍동,여성,5283,58,5341
1748,2019,9,성산읍,남성,8164,1185,9349
1749,2019,9,성산읍,여성,7442,605,8047
1750,2019,9,송산동,남성,2263,435,2698
1751,2019,9,송산동,여성,2011,167,2178
1752,2019,9,아라동,남성,17147,649,17796
1753,2019,9,아라동,여성,17210,631,17841
1754,2019,9,안덕면,남성,6186,353,6539
1755,2019,9,안덕면,여성,5795,415,6210
1756,2019,9,애월읍,남성,18693,570,19263
1757,2019,9,애월읍,여성,17417,514,17931
1758,2019,9,연동,남성,20383,1046,21429
1759,2019,9,연동,여성,21139,1125,22264
1760,2019,9,영천동,남성,2746,125,2871
1761,2019,9,영천동,여성,2619,66,2685
1762,2019,9,예래동,남성,2071,136,2207
1763,2019,9,예래동,여성,1971,146,2117
1764,2019,9,오라동,남성,7711,120,7831
1765,2019,9,오라동,여성,7555,129,7684
1766,2019,9,외도동,남성,10906,124,11030
1767,2019,9,외도동,여성,10754,171,10925
1768,2019,9,용담1동,남성,3755,37,3792
1769,2019,9,용담1동,여성,3552,54,3606
1770,2019,9,용담2동,남성,7659,78,7737
1771,2019,9,용담2동,여성,7537,180,7717
1772,2019,9,우도면,남성,985,19,1004
1773,2019,9,우도면,여성,898,13,911
1774,2019,9,이도1동,남성,3771,62,3833
1775,2019,9,이도1동,여성,3889,93,3982
1776,2019,9,이도2동,남성,24652,294,24946
1777,2019,9,이도2동,여성,25436,382,25818
1778,2019,9,이호동,남성,2346,87,2433
1779,2019,9,이호동,여성,2199,88,2287
1780,2019,9,일도1동,남성,1456,53,1509
1781,2019,9,일도1동,여성,1319,40,1359
1782,2019,9,일도2동,남성,16689,105,16794
1783,2019,9,일도2동,여성,17196,218,17414
1784,2019,9,정방동,남성,1146,65,1211
1785,2019,9,정방동,여성,1138,57,1195
1786,2019,9,조천읍,남성,12583,336,12919
1787,2019,9,조천읍,여성,11948,247,12195
1788,2019,9,중문동,남성,5781,172,5953
1789,2019,9,중문동,여성,5459,167,5626
1790,2019,9,중앙동,남성,1789,52,1841
1791,2019,9,중앙동,여성,1960,50,2010
1792,2019,9,천지동,남성,1806,63,1869
1793,2019,9,천지동,여성,1754,54,1808
1794,2019,9,추자면,남성,953,319,1272
1795,2019,9,추자면,여성,790,17,807
1796,2019,9,표선면,남성,6341,290,6631
1797,2019,9,표선면,여성,5989,155,6144
1798,2019,9,한경면,남성,4562,249,4811
1799,2019,9,한경면,여성,4503,109,4612
1800,2019,9,한림읍,남성,11011,2348,13359
1801,2019,9,한림읍,여성,10377,1348,11725
1802,2019,9,화북동,남성,12428,229,12657
1803,2019,9,화북동,여성,12444,192,12636
1804,2019,9,효돈동,남성,2690,51,2741
1805,2019,9,효돈동,여성,2611,28,2639
1806,2019,10,건입동,남성,4796,159,4955
1807,2019,10,건입동,여성,4563,102,4665
1808,2019,10,구좌읍,남성,8002,462,8464
1809,2019,10,구좌읍,여성,7603,207,7810
1810,2019,10,남원읍,남성,9768,530,10298
1811,2019,10,남원읍,여성,9222,281,9503
1812,2019,10,노형동,남성,26578,1347,27925
1813,2019,10,노형동,여성,27517,1085,28602
1814,2019,10,대륜동,남성,7259,98,7357
1815,2019,10,대륜동,여성,7115,123,7238
1816,2019,10,대정읍,남성,10409,995,11404
1817,2019,10,대정읍,여성,10939,789,11728
1818,2019,10,대천동,남성,7007,103,7110
1819,2019,10,대천동,여성,6797,125,6922
1820,2019,10,도두동,남성,1676,73,1749
1821,2019,10,도두동,여성,1504,62,1566
1822,2019,10,동홍동,남성,11300,623,11923
1823,2019,10,동홍동,여성,11761,650,12411
1824,2019,10,봉개동,남성,2726,42,2768
1825,2019,10,봉개동,여성,2504,53,2557
1826,2019,10,삼도1동,남성,6810,72,6882
1827,2019,10,삼도1동,여성,7076,84,7160
1828,2019,10,삼도2동,남성,4253,156,4409
1829,2019,10,삼도2동,여성,3933,99,4032
1830,2019,10,삼양동,남성,12850,94,12944
1831,2019,10,삼양동,여성,12694,163,12857
1832,2019,10,서홍동,남성,5165,66,5231
1833,2019,10,서홍동,여성,5256,59,5315
1834,2019,10,성산읍,남성,8166,1175,9341
1835,2019,10,성산읍,여성,7440,607,8047
1836,2019,10,송산동,남성,2264,437,2701
1837,2019,10,송산동,여성,2005,168,2173
1838,2019,10,아라동,남성,17263,640,17903
1839,2019,10,아라동,여성,17329,622,17951
1840,2019,10,안덕면,남성,6171,345,6516
1841,2019,10,안덕면,여성,5796,390,6186
1842,2019,10,애월읍,남성,18693,573,19266
1843,2019,10,애월읍,여성,17439,542,17981
1844,2019,10,연동,남성,20355,1066,21421
1845,2019,10,연동,여성,21110,1131,22241
1846,2019,10,영천동,남성,2745,130,2875
1847,2019,10,영천동,여성,2605,65,2670
1848,2019,10,예래동,남성,2053,135,2188
1849,2019,10,예래동,여성,1961,146,2107
1850,2019,10,오라동,남성,7736,118,7854
1851,2019,10,오라동,여성,7551,130,7681
1852,2019,10,외도동,남성,10927,123,11050
1853,2019,10,외도동,여성,10767,178,10945
1854,2019,10,용담1동,남성,3757,40,3797
1855,2019,10,용담1동,여성,3537,54,3591
1856,2019,10,용담2동,남성,7617,81,7698
1857,2019,10,용담2동,여성,7507,182,7689
1858,2019,10,우도면,남성,983,20,1003
1859,2019,10,우도면,여성,899,13,912
1860,2019,10,이도1동,남성,3760,58,3818
1861,2019,10,이도1동,여성,3896,91,3987
1862,2019,10,이도2동,남성,24623,303,24926
1863,2019,10,이도2동,여성,25458,383,25841
1864,2019,10,이호동,남성,2360,87,2447
1865,2019,10,이호동,여성,2212,90,2302
1866,2019,10,일도1동,남성,1439,48,1487
1867,2019,10,일도1동,여성,1308,42,1350
1868,2019,10,일도2동,남성,16668,104,16772
1869,2019,10,일도2동,여성,17188,217,17405
1870,2019,10,정방동,남성,1154,66,1220
1871,2019,10,정방동,여성,1140,59,1199
1872,2019,10,조천읍,남성,12607,342,12949
1873,2019,10,조천읍,여성,11961,245,12206
1874,2019,10,중문동,남성,5773,170,5943
1875,2019,10,중문동,여성,5460,164,5624
1876,2019,10,중앙동,남성,1781,52,1833
1877,2019,10,중앙동,여성,1966,51,2017
1878,2019,10,천지동,남성,1806,64,1870
1879,2019,10,천지동,여성,1753,55,1808
1880,2019,10,추자면,남성,942,318,1260
1881,2019,10,추자면,여성,790,17,807
1882,2019,10,표선면,남성,6336,291,6627
1883,2019,10,표선면,여성,5973,153,6126
1884,2019,10,한경면,남성,4582,251,4833
1885,2019,10,한경면,여성,4490,109,4599
1886,2019,10,한림읍,남성,11013,2383,13396
1887,2019,10,한림읍,여성,10367,1347,11714
1888,2019,10,화북동,남성,12424,238,12662
1889,2019,10,화북동,여성,12446,195,12641
1890,2019,10,효돈동,남성,2685,52,2737
1891,2019,10,효돈동,여성,2618,31,2649
1892,2019,11,건입동,남성,4776,155,4931
1893,2019,11,건입동,여성,4559,97,4656
1894,2019,11,구좌읍,남성,7991,455,8446
1895,2019,11,구좌읍,여성,7565,203,7768
1896,2019,11,남원읍,남성,9738,533,10271
1897,2019,11,남원읍,여성,9198,282,9480
1898,2019,11,노형동,남성,26620,1324,27944
1899,2019,11,노형동,여성,27603,1085,28688
1900,2019,11,대륜동,남성,7277,101,7378
1901,2019,11,대륜동,여성,7113,120,7233
1902,2019,11,대정읍,남성,10426,995,11421
1903,2019,11,대정읍,여성,10941,789,11730
1904,2019,11,대천동,남성,6986,110,7096
1905,2019,11,대천동,여성,6773,127,6900
1906,2019,11,도두동,남성,1671,68,1739
1907,2019,11,도두동,여성,1505,63,1568
1908,2019,11,동홍동,남성,11329,625,11954
1909,2019,11,동홍동,여성,11775,651,12426
1910,2019,11,봉개동,남성,2734,41,2775
1911,2019,11,봉개동,여성,2521,51,2572
1912,2019,11,삼도1동,남성,6797,68,6865
1913,2019,11,삼도1동,여성,7070,86,7156
1914,2019,11,삼도2동,남성,4258,162,4420
1915,2019,11,삼도2동,여성,3924,105,4029
1916,2019,11,삼양동,남성,12877,97,12974
1917,2019,11,삼양동,여성,12734,165,12899
1918,2019,11,서홍동,남성,5177,67,5244
1919,2019,11,서홍동,여성,5259,59,5318
1920,2019,11,성산읍,남성,8153,1201,9354
1921,2019,11,성산읍,여성,7451,609,8060
1922,2019,11,송산동,남성,2255,436,2691
1923,2019,11,송산동,여성,2007,170,2177
1924,2019,11,아라동,남성,17310,639,17949
1925,2019,11,아라동,여성,17417,631,18048
1926,2019,11,안덕면,남성,6190,341,6531
1927,2019,11,안덕면,여성,5798,385,6183
1928,2019,11,애월읍,남성,18698,568,19266
1929,2019,11,애월읍,여성,17484,549,18033
1930,2019,11,연동,남성,20370,1079,21449
1931,2019,11,연동,여성,21104,1129,22233
1932,2019,11,영천동,남성,2743,128,2871
1933,2019,11,영천동,여성,2608,64,2672
1934,2019,11,예래동,남성,2036,134,2170
1935,2019,11,예래동,여성,1961,149,2110
1936,2019,11,오라동,남성,7739,119,7858
1937,2019,11,오라동,여성,7561,131,7692
1938,2019,11,외도동,남성,10943,121,11064
1939,2019,11,외도동,여성,10777,179,10956
1940,2019,11,용담1동,남성,3731,43,3774
1941,2019,11,용담1동,여성,3519,52,3571
1942,2019,11,용담2동,남성,7593,80,7673
1943,2019,11,용담2동,여성,7491,179,7670
1944,2019,11,우도면,남성,979,20,999
1945,2019,11,우도면,여성,883,12,895
1946,2019,11,이도1동,남성,3752,57,3809
1947,2019,11,이도1동,여성,3865,85,3950
1948,2019,11,이도2동,남성,24599,297,24896
1949,2019,11,이도2동,여성,25439,386,25825
1950,2019,11,이호동,남성,2357,91,2448
1951,2019,11,이호동,여성,2190,93,2283
1952,2019,11,일도1동,남성,1426,46,1472
1953,2019,11,일도1동,여성,1305,42,1347
1954,2019,11,일도2동,남성,16630,105,16735
1955,2019,11,일도2동,여성,17161,218,17379
1956,2019,11,정방동,남성,1148,68,1216
1957,2019,11,정방동,여성,1141,60,1201
1958,2019,11,조천읍,남성,12637,367,13004
1959,2019,11,조천읍,여성,11977,257,12234
1960,2019,11,중문동,남성,5795,171,5966
1961,2019,11,중문동,여성,5499,158,5657
1962,2019,11,중앙동,남성,1765,47,1812
1963,2019,11,중앙동,여성,1960,50,2010
1964,2019,11,천지동,남성,1803,63,1866
1965,2019,11,천지동,여성,1745,54,1799
1966,2019,11,추자면,남성,946,329,1275
1967,2019,11,추자면,여성,789,17,806
1968,2019,11,표선면,남성,6354,286,6640
1969,2019,11,표선면,여성,5964,157,6121
1970,2019,11,한경면,남성,4577,260,4837
1971,2019,11,한경면,여성,4482,108,4590
1972,2019,11,한림읍,남성,11023,2396,13419
1973,2019,11,한림읍,여성,10377,1353,11730
1974,2019,11,화북동,남성,12447,234,12681
1975,2019,11,화북동,여성,12447,195,12642
1976,2019,11,효돈동,남성,2683,50,2733
1977,2019,11,효돈동,여성,2614,30,2644
1978,2019,12,건입동,남성,4774,163,4937
1979,2019,12,건입동,여성,4537,97,4634
1980,2019,12,구좌읍,남성,8014,440,8454
1981,2019,12,구좌읍,여성,7575,203,7778
1982,2019,12,남원읍,남성,9739,527,10266
1983,2019,12,남원읍,여성,9166,275,9441
1984,2019,12,노형동,남성,26628,1295,27923
1985,2019,12,노형동,여성,27594,1094,28688
1986,2019,12,대륜동,남성,7292,98,7390
1987,2019,12,대륜동,여성,7151,116,7267
1988,2019,12,대정읍,남성,10392,991,11383
1989,2019,12,대정읍,여성,10942,780,11722
1990,2019,12,대천동,남성,6997,102,7099
1991,2019,12,대천동,여성,6788,123,6911
1992,2019,12,도두동,남성,1673,68,1741
1993,2019,12,도두동,여성,1513,60,1573
1994,2019,12,동홍동,남성,11341,621,11962
1995,2019,12,동홍동,여성,11777,650,12427
1996,2019,12,봉개동,남성,2740,42,2782
1997,2019,12,봉개동,여성,2530,51,2581
1998,2019,12,삼도1동,남성,6788,66,6854
1999,2019,12,삼도1동,여성,7066,85,7151
2000,2019,12,삼도2동,남성,4254,160,4414
2001,2019,12,삼도2동,여성,3920,99,4019
2002,2019,12,삼양동,남성,12933,101,13034
2003,2019,12,삼양동,여성,12769,162,12931
2004,2019,12,서홍동,남성,5171,67,5238
2005,2019,12,서홍동,여성,5262,59,5321
2006,2019,12,성산읍,남성,8140,1189,9329
2007,2019,12,성산읍,여성,7417,592,8009
2008,2019,12,송산동,남성,2264,436,2700
2009,2019,12,송산동,여성,2022,171,2193
2010,2019,12,아라동,남성,17352,615,17967
2011,2019,12,아라동,여성,17454,603,18057
2012,2019,12,안덕면,남성,6218,324,6542
2013,2019,12,안덕면,여성,5805,364,6169
2014,2019,12,애월읍,남성,18718,571,19289
2015,2019,12,애월읍,여성,17515,541,18056
2016,2019,12,연동,남성,20376,1062,21438
2017,2019,12,연동,여성,21137,1133,22270
2018,2019,12,영천동,남성,2705,131,2836
2019,2019,12,영천동,여성,2584,65,2649
2020,2019,12,예래동,남성,2023,130,2153
2021,2019,12,예래동,여성,1951,143,2094
2022,2019,12,오라동,남성,7741,122,7863
2023,2019,12,오라동,여성,7593,132,7725
2024,2019,12,외도동,남성,11002,125,11127
2025,2019,12,외도동,여성,10799,182,10981
2026,2019,12,용담1동,남성,3714,41,3755
2027,2019,12,용담1동,여성,3511,49,3560
2028,2019,12,용담2동,남성,7580,77,7657
2029,2019,12,용담2동,여성,7494,177,7671
2030,2019,12,우도면,남성,974,19,993
2031,2019,12,우도면,여성,888,11,899
2032,2019,12,이도1동,남성,3773,56,3829
2033,2019,12,이도1동,여성,3876,91,3967
2034,2019,12,이도2동,남성,24554,305,24859
2035,2019,12,이도2동,여성,25410,386,25796
2036,2019,12,이호동,남성,2374,95,2469
2037,2019,12,이호동,여성,2195,100,2295
2038,2019,12,일도1동,남성,1423,43,1466
2039,2019,12,일도1동,여성,1301,42,1343
2040,2019,12,일도2동,남성,16565,102,16667
2041,2019,12,일도2동,여성,17118,213,17331
2042,2019,12,정방동,남성,1142,66,1208
2043,2019,12,정방동,여성,1134,57,1191
2044,2019,12,조천읍,남성,12666,374,13040
2045,2019,12,조천읍,여성,12004,269,12273
2046,2019,12,중문동,남성,5825,171,5996
2047,2019,12,중문동,여성,5512,157,5669
2048,2019,12,중앙동,남성,1755,42,1797
2049,2019,12,중앙동,여성,1950,51,2001
2050,2019,12,천지동,남성,1801,58,1859
2051,2019,12,천지동,여성,1743,54,1797
2052,2019,12,추자면,남성,941,311,1252
2053,2019,12,추자면,여성,792,13,805
2054,2019,12,표선면,남성,6331,285,6616
2055,2019,12,표선면,여성,5953,153,6106
2056,2019,12,한경면,남성,4552,261,4813
2057,2019,12,한경면,여성,4485,107,4592
2058,2019,12,한림읍,남성,11011,2383,13394
2059,2019,12,한림읍,여성,10354,1332,11686
2060,2019,12,화북동,남성,12413,226,12639
2061,2019,12,화북동,여성,12442,190,12632
2062,2019,12,효돈동,남성,2676,47,2723
2063,2019,12,효돈동,여성,2615,28,2643
2064,2020,1,건입동,남성,4721,164,4885
2065,2020,1,건입동,여성,4509,102,4611
2066,2020,1,구좌읍,남성,8004,448,8452
2067,2020,1,구좌읍,여성,7545,206,7751
2068,2020,1,남원읍,남성,9726,526,10252
2069,2020,1,남원읍,여성,9138,272,9410
2070,2020,1,노형동,남성,26590,1298,27888
2071,2020,1,노형동,여성,27558,1102,28660
2072,2020,1,대륜동,남성,7319,99,7418
2073,2020,1,대륜동,여성,7158,116,7274
2074,2020,1,대정읍,남성,10422,993,11415
2075,2020,1,대정읍,여성,10932,791,11723
2076,2020,1,대천동,남성,7002,100,7102
2077,2020,1,대천동,여성,6754,124,6878
2078,2020,1,도두동,남성,1685,67,1752
2079,2020,1,도두동,여성,1517,61,1578
2080,2020,1,동홍동,남성,11350,621,11971
2081,2020,1,동홍동,여성,11787,650,12437
2082,2020,1,봉개동,남성,2738,43,2781
2083,2020,1,봉개동,여성,2534,51,2585
2084,2020,1,삼도1동,남성,6758,65,6823
2085,2020,1,삼도1동,여성,7013,84,7097
2086,2020,1,삼도2동,남성,4229,158,4387
2087,2020,1,삼도2동,여성,3912,103,4015
2088,2020,1,삼양동,남성,12948,100,13048
2089,2020,1,삼양동,여성,12764,160,12924
2090,2020,1,서홍동,남성,5189,66,5255
2091,2020,1,서홍동,여성,5290,61,5351
2092,2020,1,성산읍,남성,8106,1204,9310
2093,2020,1,성산읍,여성,7383,598,7981
2094,2020,1,송산동,남성,2256,436,2692
2095,2020,1,송산동,여성,2009,170,2179
2096,2020,1,아라동,남성,17365,617,17982
2097,2020,1,아라동,여성,17514,601,18115
2098,2020,1,안덕면,남성,6234,335,6569
2099,2020,1,안덕면,여성,5819,370,6189
2100,2020,1,애월읍,남성,18697,578,19275
2101,2020,1,애월읍,여성,17489,546,18035
2102,2020,1,연동,남성,20358,1070,21428
2103,2020,1,연동,여성,21129,1154,22283
2104,2020,1,영천동,남성,2704,130,2834
2105,2020,1,영천동,여성,2597,64,2661
2106,2020,1,예래동,남성,2019,133,2152
2107,2020,1,예래동,여성,1964,144,2108
2108,2020,1,오라동,남성,7770,121,7891
2109,2020,1,오라동,여성,7627,136,7763
2110,2020,1,외도동,남성,10958,130,11088
2111,2020,1,외도동,여성,10784,186,10970
2112,2020,1,용담1동,남성,3745,41,3786
2113,2020,1,용담1동,여성,3516,51,3567
2114,2020,1,용담2동,남성,7565,80,7645
2115,2020,1,용담2동,여성,7486,178,7664
2116,2020,1,우도면,남성,972,19,991
2117,2020,1,우도면,여성,888,11,899
2118,2020,1,이도1동,남성,3784,55,3839
2119,2020,1,이도1동,여성,3904,91,3995
2120,2020,1,이도2동,남성,24525,305,24830
2121,2020,1,이도2동,여성,25428,387,25815
2122,2020,1,이호동,남성,2368,95,2463
2123,2020,1,이호동,여성,2205,102,2307
2124,2020,1,일도1동,남성,1413,43,1456
2125,2020,1,일도1동,여성,1288,41,1329
2126,2020,1,일도2동,남성,16549,101,16650
2127,2020,1,일도2동,여성,17063,213,17276
2128,2020,1,정방동,남성,1137,66,1203
2129,2020,1,정방동,여성,1121,57,1178
2130,2020,1,조천읍,남성,12747,376,13123
2131,2020,1,조천읍,여성,12056,275,12331
2132,2020,1,중문동,남성,5838,170,6008
2133,2020,1,중문동,여성,5527,158,5685
2134,2020,1,중앙동,남성,1741,42,1783
2135,2020,1,중앙동,여성,1935,52,1987
2136,2020,1,천지동,남성,1814,57,1871
2137,2020,1,천지동,여성,1744,54,1798
2138,2020,1,추자면,남성,929,314,1243
2139,2020,1,추자면,여성,788,13,801
2140,2020,1,표선면,남성,6312,289,6601
2141,2020,1,표선면,여성,5936,148,6084
2142,2020,1,한경면,남성,4559,262,4821
2143,2020,1,한경면,여성,4485,108,4593
2144,2020,1,한림읍,남성,11004,2375,13379
2145,2020,1,한림읍,여성,10369,1328,11697
2146,2020,1,화북동,남성,12408,227,12635
2147,2020,1,화북동,여성,12442,191,12633
2148,2020,1,효돈동,남성,2673,47,2720
2149,2020,1,효돈동,여성,2611,28,2639
2150,2020,2,건입동,남성,4705,169,4874
2151,2020,2,건입동,여성,4504,104,4608
2152,2020,2,구좌읍,남성,8008,442,8450
2153,2020,2,구좌읍,여성,7546,206,7752
2154,2020,2,남원읍,남성,9716,526,10242
2155,2020,2,남원읍,여성,9138,272,9410
2156,2020,2,노형동,남성,26643,1286,27929
2157,2020,2,노형동,여성,27601,1106,28707
2158,2020,2,대륜동,남성,7317,100,7417
2159,2020,2,대륜동,여성,7175,121,7296
2160,2020,2,대정읍,남성,10417,994,11411
2161,2020,2,대정읍,여성,10912,789,11701
2162,2020,2,대천동,남성,7015,99,7114
2163,2020,2,대천동,여성,6775,125,6900
2164,2020,2,도두동,남성,1697,68,1765
2165,2020,2,도두동,여성,1524,62,1586
2166,2020,2,동홍동,남성,11336,620,11956
2167,2020,2,동홍동,여성,11800,650,12450
2168,2020,2,봉개동,남성,2739,45,2784
2169,2020,2,봉개동,여성,2526,51,2577
2170,2020,2,삼도1동,남성,6754,65,6819
2171,2020,2,삼도1동,여성,6989,84,7073
2172,2020,2,삼도2동,남성,4215,160,4375
2173,2020,2,삼도2동,여성,3901,107,4008
2174,2020,2,삼양동,남성,12962,99,13061
2175,2020,2,삼양동,여성,12767,161,12928
2176,2020,2,서홍동,남성,5193,64,5257
2177,2020,2,서홍동,여성,5277,56,5333
2178,2020,2,성산읍,남성,8075,1191,9266
2179,2020,2,성산읍,여성,7359,600,7959
2180,2020,2,송산동,남성,2246,431,2677
2181,2020,2,송산동,여성,2017,174,2191
2182,2020,2,아라동,남성,17399,603,18002
2183,2020,2,아라동,여성,17556,583,18139
2184,2020,2,안덕면,남성,6224,327,6551
2185,2020,2,안덕면,여성,5820,367,6187
2186,2020,2,애월읍,남성,18784,566,19350
2187,2020,2,애월읍,여성,17549,547,18096
2188,2020,2,연동,남성,20329,1080,21409
2189,2020,2,연동,여성,21157,1169,22326
2190,2020,2,영천동,남성,2691,126,2817
2191,2020,2,영천동,여성,2590,64,2654
2192,2020,2,예래동,남성,2021,135,2156
2193,2020,2,예래동,여성,1957,146,2103
2194,2020,2,오라동,남성,7788,122,7910
2195,2020,2,오라동,여성,7637,136,7773
2196,2020,2,외도동,남성,10943,126,11069
2197,2020,2,외도동,여성,10814,183,10997
2198,2020,2,용담1동,남성,3733,44,3777
2199,2020,2,용담1동,여성,3508,53,3561
2200,2020,2,용담2동,남성,7572,79,7651
2201,2020,2,용담2동,여성,7479,174,7653
2202,2020,2,우도면,남성,971,18,989
2203,2020,2,우도면,여성,872,11,883
2204,2020,2,이도1동,남성,3797,54,3851
2205,2020,2,이도1동,여성,3905,89,3994
2206,2020,2,이도2동,남성,24529,305,24834
2207,2020,2,이도2동,여성,25413,395,25808
2208,2020,2,이호동,남성,2360,90,2450
2209,2020,2,이호동,여성,2193,103,2296
2210,2020,2,일도1동,남성,1401,42,1443
2211,2020,2,일도1동,여성,1270,39,1309
2212,2020,2,일도2동,남성,16538,101,16639
2213,2020,2,일도2동,여성,17040,213,17253
2214,2020,2,정방동,남성,1137,67,1204
2215,2020,2,정방동,여성,1122,59,1181
2216,2020,2,조천읍,남성,12820,369,13189
2217,2020,2,조천읍,여성,12117,283,12400
2218,2020,2,중문동,남성,5838,169,6007
2219,2020,2,중문동,여성,5533,157,5690
2220,2020,2,중앙동,남성,1735,46,1781
2221,2020,2,중앙동,여성,1927,52,1979
2222,2020,2,천지동,남성,1804,56,1860
2223,2020,2,천지동,여성,1731,54,1785
2224,2020,2,추자면,남성,931,302,1233
2225,2020,2,추자면,여성,798,14,812
2226,2020,2,표선면,남성,6311,288,6599
2227,2020,2,표선면,여성,5941,149,6090
2228,2020,2,한경면,남성,4560,259,4819
2229,2020,2,한경면,여성,4485,112,4597
2230,2020,2,한림읍,남성,10985,2367,13352
2231,2020,2,한림읍,여성,10341,1328,11669
2232,2020,2,화북동,남성,12383,222,12605
2233,2020,2,화북동,여성,12418,190,12608
2234,2020,2,효돈동,남성,2673,47,2720
2235,2020,2,효돈동,여성,2597,27,2624
2236,2020,3,건입동,남성,4694,161,4855
2237,2020,3,건입동,여성,4508,102,4610
2238,2020,3,구좌읍,남성,7989,425,8414
2239,2020,3,구좌읍,여성,7525,200,7725
2240,2020,3,남원읍,남성,9692,517,10209
2241,2020,3,남원읍,여성,9132,274,9406
2242,2020,3,노형동,남성,26620,1271,27891
2243,2020,3,노형동,여성,27573,1082,28655
2244,2020,3,대륜동,남성,7299,98,7397
2245,2020,3,대륜동,여성,7165,116,7281
2246,2020,3,대정읍,남성,10424,982,11406
2247,2020,3,대정읍,여성,10914,786,11700
2248,2020,3,대천동,남성,6988,96,7084
2249,2020,3,대천동,여성,6769,121,6890
2250,2020,3,도두동,남성,1688,65,1753
2251,2020,3,도두동,여성,1514,60,1574
2252,2020,3,동홍동,남성,11361,606,11967
2253,2020,3,동홍동,여성,11826,639,12465
2254,2020,3,봉개동,남성,2747,46,2793
2255,2020,3,봉개동,여성,2511,49,2560
2256,2020,3,삼도1동,남성,6740,65,6805
2257,2020,3,삼도1동,여성,6971,82,7053
2258,2020,3,삼도2동,남성,4193,162,4355
2259,2020,3,삼도2동,여성,3882,109,3991
2260,2020,3,삼양동,남성,12949,97,13046
2261,2020,3,삼양동,여성,12807,160,12967
2262,2020,3,서홍동,남성,5190,65,5255
2263,2020,3,서홍동,여성,5261,54,5315
2264,2020,3,성산읍,남성,8040,1171,9211
2265,2020,3,성산읍,여성,7301,595,7896
2266,2020,3,송산동,남성,2235,423,2658
2267,2020,3,송산동,여성,2010,173,2183
2268,2020,3,아라동,남성,17404,596,18000
2269,2020,3,아라동,여성,17604,563,18167
2270,2020,3,안덕면,남성,6228,317,6545
2271,2020,3,안덕면,여성,5792,337,6129
2272,2020,3,애월읍,남성,18789,548,19337
2273,2020,3,애월읍,여성,17570,526,18096
2274,2020,3,연동,남성,20290,1059,21349
2275,2020,3,연동,여성,21145,1154,22299
2276,2020,3,영천동,남성,2698,123,2821
2277,2020,3,영천동,여성,2599,61,2660
2278,2020,3,예래동,남성,2016,127,2143
2279,2020,3,예래동,여성,1948,144,2092
2280,2020,3,오라동,남성,7835,118,7953
2281,2020,3,오라동,여성,7687,129,7816
2282,2020,3,외도동,남성,10942,119,11061
2283,2020,3,외도동,여성,10831,184,11015
2284,2020,3,용담1동,남성,3724,41,3765
2285,2020,3,용담1동,여성,3502,51,3553
2286,2020,3,용담2동,남성,7569,81,7650
2287,2020,3,용담2동,여성,7468,171,7639
2288,2020,3,우도면,남성,963,15,978
2289,2020,3,우도면,여성,865,11,876
2290,2020,3,이도1동,남성,3806,53,3859
2291,2020,3,이도1동,여성,3885,81,3966
2292,2020,3,이도2동,남성,24570,298,24868
2293,2020,3,이도2동,여성,25441,385,25826
2294,2020,3,이호동,남성,2367,90,2457
2295,2020,3,이호동,여성,2193,102,2295
2296,2020,3,일도1동,남성,1405,40,1445
2297,2020,3,일도1동,여성,1271,37,1308
2298,2020,3,일도2동,남성,16477,100,16577
2299,2020,3,일도2동,여성,17016,213,17229
2300,2020,3,정방동,남성,1130,64,1194
2301,2020,3,정방동,여성,1113,59,1172
2302,2020,3,조천읍,남성,12812,365,13177
2303,2020,3,조천읍,여성,12152,279,12431
2304,2020,3,중문동,남성,5866,170,6036
2305,2020,3,중문동,여성,5510,155,5665
2306,2020,3,중앙동,남성,1711,44,1755
2307,2020,3,중앙동,여성,1923,52,1975
2308,2020,3,천지동,남성,1811,55,1866
2309,2020,3,천지동,여성,1735,51,1786
2310,2020,3,추자면,남성,918,290,1208
2311,2020,3,추자면,여성,786,14,800
2312,2020,3,표선면,남성,6308,281,6589
2313,2020,3,표선면,여성,5955,143,6098
2314,2020,3,한경면,남성,4566,249,4815
2315,2020,3,한경면,여성,4484,110,4594
2316,2020,3,한림읍,남성,10970,2340,13310
2317,2020,3,한림읍,여성,10310,1322,11632
2318,2020,3,화북동,남성,12351,215,12566
2319,2020,3,화북동,여성,12392,184,12576
2320,2020,3,효돈동,남성,2680,47,2727
2321,2020,3,효돈동,여성,2607,27,2634
2322,2020,4,건입동,남성,4680,153,4833
2323,2020,4,건입동,여성,4490,97,4587
2324,2020,4,구좌읍,남성,7949,422,8371
2325,2020,4,구좌읍,여성,7484,196,7680
2326,2020,4,남원읍,남성,9688,504,10192
2327,2020,4,남원읍,여성,9125,267,9392
2328,2020,4,노형동,남성,26666,1253,27919
2329,2020,4,노형동,여성,27588,1078,28666
2330,2020,4,대륜동,남성,7311,98,7409
2331,2020,4,대륜동,여성,7150,115,7265
2332,2020,4,대정읍,남성,10414,983,11397
2333,2020,4,대정읍,여성,10899,782,11681
2334,2020,4,대천동,남성,7037,96,7133
2335,2020,4,대천동,여성,6802,119,6921
2336,2020,4,도두동,남성,1691,65,1756
2337,2020,4,도두동,여성,1519,61,1580
2338,2020,4,동홍동,남성,11358,604,11962
2339,2020,4,동홍동,여성,11821,635,12456
2340,2020,4,봉개동,남성,2750,46,2796
2341,2020,4,봉개동,여성,2522,46,2568
2342,2020,4,삼도1동,남성,6727,67,6794
2343,2020,4,삼도1동,여성,6970,87,7057
2344,2020,4,삼도2동,남성,4216,160,4376
2345,2020,4,삼도2동,여성,3893,108,4001
2346,2020,4,삼양동,남성,12935,97,13032
2347,2020,4,삼양동,여성,12791,157,12948
2348,2020,4,서홍동,남성,5172,64,5236
2349,2020,4,서홍동,여성,5252,51,5303
2350,2020,4,성산읍,남성,8016,1161,9177
2351,2020,4,성산읍,여성,7274,591,7865
2352,2020,4,송산동,남성,2224,420,2644
2353,2020,4,송산동,여성,1999,170,2169
2354,2020,4,아라동,남성,17486,571,18057
2355,2020,4,아라동,여성,17658,512,18170
2356,2020,4,안덕면,남성,6190,309,6499
2357,2020,4,안덕면,여성,5790,333,6123
2358,2020,4,애월읍,남성,18806,541,19347
2359,2020,4,애월읍,여성,17590,507,18097
2360,2020,4,연동,남성,20323,1023,21346
2361,2020,4,연동,여성,21177,1128,22305
2362,2020,4,영천동,남성,2700,122,2822
2363,2020,4,영천동,여성,2588,59,2647
2364,2020,4,예래동,남성,2031,124,2155
2365,2020,4,예래동,여성,1923,145,2068
2366,2020,4,오라동,남성,7877,118,7995
2367,2020,4,오라동,여성,7734,130,7864
2368,2020,4,외도동,남성,10964,120,11084
2369,2020,4,외도동,여성,10841,185,11026
2370,2020,4,용담1동,남성,3709,41,3750
2371,2020,4,용담1동,여성,3504,50,3554
2372,2020,4,용담2동,남성,7569,80,7649
2373,2020,4,용담2동,여성,7441,168,7609
2374,2020,4,우도면,남성,953,15,968
2375,2020,4,우도면,여성,859,11,870
2376,2020,4,이도1동,남성,3809,53,3862
2377,2020,4,이도1동,여성,3877,83,3960
2378,2020,4,이도2동,남성,24591,292,24883
2379,2020,4,이도2동,여성,25449,384,25833
2380,2020,4,이호동,남성,2372,89,2461
2381,2020,4,이호동,여성,2204,102,2306
2382,2020,4,일도1동,남성,1411,39,1450
2383,2020,4,일도1동,여성,1264,38,1302
2384,2020,4,일도2동,남성,16429,98,16527
2385,2020,4,일도2동,여성,16976,214,17190
2386,2020,4,정방동,남성,1123,65,1188
2387,2020,4,정방동,여성,1115,59,1174
2388,2020,4,조천읍,남성,12828,368,13196
2389,2020,4,조천읍,여성,12167,283,12450
2390,2020,4,중문동,남성,5864,169,6033
2391,2020,4,중문동,여성,5526,154,5680
2392,2020,4,중앙동,남성,1720,42,1762
2393,2020,4,중앙동,여성,1914,51,1965
2394,2020,4,천지동,남성,1803,54,1857
2395,2020,4,천지동,여성,1742,53,1795
2396,2020,4,추자면,남성,914,284,1198
2397,2020,4,추자면,여성,784,12,796
2398,2020,4,표선면,남성,6316,278,6594
2399,2020,4,표선면,여성,5970,142,6112
2400,2020,4,한경면,남성,4540,247,4787
2401,2020,4,한경면,여성,4481,109,4590
2402,2020,4,한림읍,남성,10950,2329,13279
2403,2020,4,한림읍,여성,10302,1317,11619
2404,2020,4,화북동,남성,12341,211,12552
2405,2020,4,화북동,여성,12415,186,12601
2406,2020,4,효돈동,남성,2666,46,2712
2407,2020,4,효돈동,여성,2606,28,2634
2408,2020,5,건입동,남성,4678,149,4827
2409,2020,5,건입동,여성,4486,96,4582
2410,2020,5,구좌읍,남성,7955,418,8373
2411,2020,5,구좌읍,여성,7497,196,7693
2412,2020,5,남원읍,남성,9660,495,10155
2413,2020,5,남원읍,여성,9098,262,9360
2414,2020,5,노형동,남성,26710,1238,27948
2415,2020,5,노형동,여성,27599,1068,28667
2416,2020,5,대륜동,남성,7318,98,7416
2417,2020,5,대륜동,여성,7149,110,7259
2418,2020,5,대정읍,남성,10397,964,11361
2419,2020,5,대정읍,여성,10919,773,11692
2420,2020,5,대천동,남성,7022,94,7116
2421,2020,5,대천동,여성,6797,114,6911
2422,2020,5,도두동,남성,1685,61,1746
2423,2020,5,도두동,여성,1527,60,1587
2424,2020,5,동홍동,남성,11352,593,11945
2425,2020,5,동홍동,여성,11833,622,12455
2426,2020,5,봉개동,남성,2742,44,2786
2427,2020,5,봉개동,여성,2506,45,2551
2428,2020,5,삼도1동,남성,6703,69,6772
2429,2020,5,삼도1동,여성,6968,86,7054
2430,2020,5,삼도2동,남성,4203,153,4356
2431,2020,5,삼도2동,여성,3897,109,4006
2432,2020,5,삼양동,남성,12945,93,13038
2433,2020,5,삼양동,여성,12798,157,12955
2434,2020,5,서홍동,남성,5171,67,5238
2435,2020,5,서홍동,여성,5267,50,5317
2436,2020,5,성산읍,남성,8008,1148,9156
2437,2020,5,성산읍,여성,7282,585,7867
2438,2020,5,송산동,남성,2205,417,2622
2439,2020,5,송산동,여성,1990,166,2156
2440,2020,5,아라동,남성,17556,563,18119
2441,2020,5,아라동,여성,17725,506,18231
2442,2020,5,안덕면,남성,6172,311,6483
2443,2020,5,안덕면,여성,5802,331,6133
2444,2020,5,애월읍,남성,18841,529,19370
2445,2020,5,애월읍,여성,17675,506,18181
2446,2020,5,연동,남성,20316,1014,21330
2447,2020,5,연동,여성,21212,1115,22327
2448,2020,5,영천동,남성,2684,120,2804
2449,2020,5,영천동,여성,2577,58,2635
2450,2020,5,예래동,남성,2022,125,2147
2451,2020,5,예래동,여성,1904,146,2050
2452,2020,5,오라동,남성,7919,115,8034
2453,2020,5,오라동,여성,7784,135,7919
2454,2020,5,외도동,남성,10990,116,11106
2455,2020,5,외도동,여성,10876,185,11061
2456,2020,5,용담1동,남성,3706,40,3746
2457,2020,5,용담1동,여성,3497,50,3547
2458,2020,5,용담2동,남성,7561,77,7638
2459,2020,5,용담2동,여성,7431,159,7590
2460,2020,5,우도면,남성,938,14,952
2461,2020,5,우도면,여성,854,12,866
2462,2020,5,이도1동,남성,3816,54,3870
2463,2020,5,이도1동,여성,3860,81,3941
2464,2020,5,이도2동,남성,24629,287,24916
2465,2020,5,이도2동,여성,25445,379,25824
2466,2020,5,이호동,남성,2374,85,2459
2467,2020,5,이호동,여성,2209,99,2308
2468,2020,5,일도1동,남성,1406,41,1447
2469,2020,5,일도1동,여성,1259,38,1297
2470,2020,5,일도2동,남성,16405,94,16499
2471,2020,5,일도2동,여성,16957,220,17177
2472,2020,5,정방동,남성,1126,63,1189
2473,2020,5,정방동,여성,1105,58,1163
2474,2020,5,조천읍,남성,12804,340,13144
2475,2020,5,조천읍,여성,12172,259,12431
2476,2020,5,중문동,남성,5902,157,6059
2477,2020,5,중문동,여성,5569,152,5721
2478,2020,5,중앙동,남성,1727,39,1766
2479,2020,5,중앙동,여성,1914,50,1964
2480,2020,5,천지동,남성,1809,55,1864
2481,2020,5,천지동,여성,1747,50,1797
2482,2020,5,추자면,남성,912,280,1192
2483,2020,5,추자면,여성,784,12,796
2484,2020,5,표선면,남성,6313,267,6580
2485,2020,5,표선면,여성,5964,133,6097
2486,2020,5,한경면,남성,4536,262,4798
2487,2020,5,한경면,여성,4475,130,4605
2488,2020,5,한림읍,남성,10923,2309,13232
2489,2020,5,한림읍,여성,10279,1305,11584
2490,2020,5,화북동,남성,12314,207,12521
2491,2020,5,화북동,여성,12395,185,12580
2492,2020,5,효돈동,남성,2656,45,2701
2493,2020,5,효돈동,여성,2598,26,2624
2494,2020,6,건입동,남성,4670,149,4819
2495,2020,6,건입동,여성,4480,97,4577
2496,2020,6,구좌읍,남성,7968,416,8384
2497,2020,6,구좌읍,여성,7498,195,7693
2498,2020,6,남원읍,남성,9662,492,10154
2499,2020,6,남원읍,여성,9092,260,9352
2500,2020,6,노형동,남성,26711,1232,27943
2501,2020,6,노형동,여성,27634,1058,28692
2502,2020,6,대륜동,남성,7359,100,7459
2503,2020,6,대륜동,여성,7155,111,7266
2504,2020,6,대정읍,남성,10389,937,11326
2505,2020,6,대정읍,여성,10909,735,11644
2506,2020,6,대천동,남성,7011,88,7099
2507,2020,6,대천동,여성,6809,114,6923
2508,2020,6,도두동,남성,1702,62,1764
2509,2020,6,도두동,여성,1528,60,1588
2510,2020,6,동홍동,남성,11339,586,11925
2511,2020,6,동홍동,여성,11827,616,12443
2512,2020,6,봉개동,남성,2754,43,2797
2513,2020,6,봉개동,여성,2510,47,2557
2514,2020,6,삼도1동,남성,6712,67,6779
2515,2020,6,삼도1동,여성,6980,83,7063
2516,2020,6,삼도2동,남성,4185,152,4337
2517,2020,6,삼도2동,여성,3882,108,3990
2518,2020,6,삼양동,남성,12929,94,13023
2519,2020,6,삼양동,여성,12795,158,12953
2520,2020,6,서홍동,남성,5160,69,5229
2521,2020,6,서홍동,여성,5256,50,5306
2522,2020,6,성산읍,남성,8008,1142,9150
2523,2020,6,성산읍,여성,7294,582,7876
2524,2020,6,송산동,남성,2205,419,2624
2525,2020,6,송산동,여성,1993,161,2154
2526,2020,6,아라동,남성,17639,560,18199
2527,2020,6,아라동,여성,17821,501,18322
2528,2020,6,안덕면,남성,6161,302,6463
2529,2020,6,안덕면,여성,5779,307,6086
2530,2020,6,애월읍,남성,18895,523,19418
2531,2020,6,애월읍,여성,17721,507,18228
2532,2020,6,연동,남성,20416,1007,21423
2533,2020,6,연동,여성,21244,1105,22349
2534,2020,6,영천동,남성,2674,120,2794
2535,2020,6,영천동,여성,2562,58,2620
2536,2020,6,예래동,남성,2041,127,2168
2537,2020,6,예래동,여성,1894,146,2040
2538,2020,6,오라동,남성,7921,115,8036
2539,2020,6,오라동,여성,7809,142,7951
2540,2020,6,외도동,남성,10996,116,11112
2541,2020,6,외도동,여성,10866,186,11052
2542,2020,6,용담1동,남성,3686,39,3725
2543,2020,6,용담1동,여성,3488,50,3538
2544,2020,6,용담2동,남성,7561,74,7635
2545,2020,6,용담2동,여성,7409,160,7569
2546,2020,6,우도면,남성,935,12,947
2547,2020,6,우도면,여성,846,12,858
2548,2020,6,이도1동,남성,3809,54,3863
2549,2020,6,이도1동,여성,3861,82,3943
2550,2020,6,이도2동,남성,24651,287,24938
2551,2020,6,이도2동,여성,25464,380,25844
2552,2020,6,이호동,남성,2386,85,2471
2553,2020,6,이호동,여성,2216,102,2318
2554,2020,6,일도1동,남성,1411,39,1450
2555,2020,6,일도1동,여성,1258,35,1293
2556,2020,6,일도2동,남성,16400,93,16493
2557,2020,6,일도2동,여성,16933,226,17159
2558,2020,6,정방동,남성,1127,62,1189
2559,2020,6,정방동,여성,1118,57,1175
2560,2020,6,조천읍,남성,12823,333,13156
2561,2020,6,조천읍,여성,12235,253,12488
2562,2020,6,중문동,남성,5926,156,6082
2563,2020,6,중문동,여성,5589,153,5742
2564,2020,6,중앙동,남성,1717,39,1756
2565,2020,6,중앙동,여성,1907,47,1954
2566,2020,6,천지동,남성,1805,58,1863
2567,2020,6,천지동,여성,1763,48,1811
2568,2020,6,추자면,남성,903,280,1183
2569,2020,6,추자면,여성,784,12,796
2570,2020,6,표선면,남성,6302,264,6566
2571,2020,6,표선면,여성,5974,131,6105
2572,2020,6,한경면,남성,4559,270,4829
2573,2020,6,한경면,여성,4502,136,4638
2574,2020,6,한림읍,남성,10901,2303,13204
2575,2020,6,한림읍,여성,10297,1301,11598
2576,2020,6,화북동,남성,12282,208,12490
2577,2020,6,화북동,여성,12388,186,12574
2578,2020,6,효돈동,남성,2652,47,2699
2579,2020,6,효돈동,여성,2603,26,2629
2580,2020,7,건입동,남성,4659,147,4806
2581,2020,7,건입동,여성,4477,97,4574
2582,2020,7,구좌읍,남성,7986,410,8396
2583,2020,7,구좌읍,여성,7513,192,7705
2584,2020,7,남원읍,남성,9666,486,10152
2585,2020,7,남원읍,여성,9096,257,9353
2586,2020,7,노형동,남성,26749,1218,27967
2587,2020,7,노형동,여성,27659,1054,28713
2588,2020,7,대륜동,남성,7377,102,7479
2589,2020,7,대륜동,여성,7161,110,7271
2590,2020,7,대정읍,남성,10402,914,11316
2591,2020,7,대정읍,여성,10926,717,11643
2592,2020,7,대천동,남성,7004,82,7086
2593,2020,7,대천동,여성,6822,112,6934
2594,2020,7,도두동,남성,1704,58,1762
2595,2020,7,도두동,여성,1542,60,1602
2596,2020,7,동홍동,남성,11349,576,11925
2597,2020,7,동홍동,여성,11866,598,12464
2598,2020,7,봉개동,남성,2754,41,2795
2599,2020,7,봉개동,여성,2524,45,2569
2600,2020,7,삼도1동,남성,6703,65,6768
2601,2020,7,삼도1동,여성,6968,83,7051
2602,2020,7,삼도2동,남성,4190,154,4344
2603,2020,7,삼도2동,여성,3884,107,3991
2604,2020,7,삼양동,남성,12933,94,13027
2605,2020,7,삼양동,여성,12812,153,12965
2606,2020,7,서홍동,남성,5168,72,5240
2607,2020,7,서홍동,여성,5245,47,5292
2608,2020,7,성산읍,남성,7986,1140,9126
2609,2020,7,성산읍,여성,7298,576,7874
2610,2020,7,송산동,남성,2190,411,2601
2611,2020,7,송산동,여성,1979,147,2126
2612,2020,7,아라동,남성,17681,552,18233
2613,2020,7,아라동,여성,17830,491,18321
2614,2020,7,안덕면,남성,6160,302,6462
2615,2020,7,안덕면,여성,5796,305,6101
2616,2020,7,애월읍,남성,18925,526,19451
2617,2020,7,애월읍,여성,17780,509,18289
2618,2020,7,연동,남성,20475,1003,21478
2619,2020,7,연동,여성,21269,1113,22382
2620,2020,7,영천동,남성,2668,123,2791
2621,2020,7,영천동,여성,2554,58,2612
2622,2020,7,예래동,남성,2039,129,2168
2623,2020,7,예래동,여성,1899,145,2044
2624,2020,7,오라동,남성,7921,112,8033
2625,2020,7,오라동,여성,7826,137,7963
2626,2020,7,외도동,남성,11023,116,11139
2627,2020,7,외도동,여성,10913,181,11094
2628,2020,7,용담1동,남성,3687,39,3726
2629,2020,7,용담1동,여성,3489,50,3539
2630,2020,7,용담2동,남성,7552,76,7628
2631,2020,7,용담2동,여성,7409,151,7560
2632,2020,7,우도면,남성,932,11,943
2633,2020,7,우도면,여성,846,13,859
2634,2020,7,이도1동,남성,3810,52,3862
2635,2020,7,이도1동,여성,3854,82,3936
2636,2020,7,이도2동,남성,24640,272,24912
2637,2020,7,이도2동,여성,25496,377,25873
2638,2020,7,이호동,남성,2378,88,2466
2639,2020,7,이호동,여성,2219,95,2314
2640,2020,7,일도1동,남성,1403,41,1444
2641,2020,7,일도1동,여성,1252,37,1289
2642,2020,7,일도2동,남성,16392,93,16485
2643,2020,7,일도2동,여성,16908,223,17131
2644,2020,7,정방동,남성,1126,62,1188
2645,2020,7,정방동,여성,1112,58,1170
2646,2020,7,조천읍,남성,12873,330,13203
2647,2020,7,조천읍,여성,12276,253,12529
2648,2020,7,중문동,남성,5960,155,6115
2649,2020,7,중문동,여성,5573,153,5726
2650,2020,7,중앙동,남성,1714,37,1751
2651,2020,7,중앙동,여성,1894,46,1940
2652,2020,7,천지동,남성,1792,61,1853
2653,2020,7,천지동,여성,1766,47,1813
2654,2020,7,추자면,남성,900,272,1172
2655,2020,7,추자면,여성,782,12,794
2656,2020,7,표선면,남성,6304,259,6563
2657,2020,7,표선면,여성,5986,132,6118
2658,2020,7,한경면,남성,4570,270,4840
2659,2020,7,한경면,여성,4509,138,4647
2660,2020,7,한림읍,남성,10898,2275,13173
2661,2020,7,한림읍,여성,10320,1288,11608
2662,2020,7,화북동,남성,12285,205,12490
2663,2020,7,화북동,여성,12392,187,12579
2664,2020,7,효돈동,남성,2659,47,2706
2665,2020,7,효돈동,여성,2604,25,2629
2666,2020,8,건입동,남성,4648,148,4796
2667,2020,8,건입동,여성,4468,92,4560
2668,2020,8,구좌읍,남성,7993,406,8399
2669,2020,8,구좌읍,여성,7531,188,7719
2670,2020,8,남원읍,남성,9664,486,10150
2671,2020,8,남원읍,여성,9088,251,9339
2672,2020,8,노형동,남성,26778,1195,27973
2673,2020,8,노형동,여성,27739,1034,28773
2674,2020,8,대륜동,남성,7380,102,7482
2675,2020,8,대륜동,여성,7176,112,7288
2676,2020,8,대정읍,남성,10421,952,11373
2677,2020,8,대정읍,여성,11010,779,11789
2678,2020,8,대천동,남성,7007,81,7088
2679,2020,8,대천동,여성,6822,117,6939
2680,2020,8,도두동,남성,1705,57,1762
2681,2020,8,도두동,여성,1529,59,1588
2682,2020,8,동홍동,남성,11341,561,11902
2683,2020,8,동홍동,여성,11861,589,12450
2684,2020,8,봉개동,남성,2741,40,2781
2685,2020,8,봉개동,여성,2533,47,2580
2686,2020,8,삼도1동,남성,6691,60,6751
2687,2020,8,삼도1동,여성,6964,82,7046
2688,2020,8,삼도2동,남성,4188,152,4340
2689,2020,8,삼도2동,여성,3880,107,3987
2690,2020,8,삼양동,남성,12957,94,13051
2691,2020,8,삼양동,여성,12837,151,12988
2692,2020,8,서홍동,남성,5171,71,5242
2693,2020,8,서홍동,여성,5268,45,5313
2694,2020,8,성산읍,남성,7973,1142,9115
2695,2020,8,성산읍,여성,7327,572,7899
2696,2020,8,송산동,남성,2217,392,2609
2697,2020,8,송산동,여성,1988,127,2115
2698,2020,8,아라동,남성,17889,545,18434
2699,2020,8,아라동,여성,18048,472,18520
2700,2020,8,안덕면,남성,6180,295,6475
2701,2020,8,안덕면,여성,5806,285,6091
2702,2020,8,애월읍,남성,18977,520,19497
2703,2020,8,애월읍,여성,17838,512,18350
2704,2020,8,연동,남성,20445,986,21431
2705,2020,8,연동,여성,21233,1092,22325
2706,2020,8,영천동,남성,2665,123,2788
2707,2020,8,영천동,여성,2537,56,2593
2708,2020,8,예래동,남성,2032,124,2156
2709,2020,8,예래동,여성,1902,145,2047
2710,2020,8,오라동,남성,7957,114,8071
2711,2020,8,오라동,여성,7832,135,7967
2712,2020,8,외도동,남성,11024,114,11138
2713,2020,8,외도동,여성,10903,183,11086
2714,2020,8,용담1동,남성,3673,38,3711
2715,2020,8,용담1동,여성,3486,54,3540
2716,2020,8,용담2동,남성,7540,73,7613
2717,2020,8,용담2동,여성,7385,150,7535
2718,2020,8,우도면,남성,921,11,932
2719,2020,8,우도면,여성,847,13,860
2720,2020,8,이도1동,남성,3803,53,3856
2721,2020,8,이도1동,여성,3842,77,3919
2722,2020,8,이도2동,남성,24635,265,24900
2723,2020,8,이도2동,여성,25477,369,25846
2724,2020,8,이호동,남성,2366,87,2453
2725,2020,8,이호동,여성,2214,98,2312
2726,2020,8,일도1동,남성,1392,43,1435
2727,2020,8,일도1동,여성,1248,36,1284
2728,2020,8,일도2동,남성,16351,93,16444
2729,2020,8,일도2동,여성,16881,223,17104
2730,2020,8,정방동,남성,1117,62,1179
2731,2020,8,정방동,여성,1100,58,1158
2732,2020,8,조천읍,남성,12882,324,13206
2733,2020,8,조천읍,여성,12286,250,12536
2734,2020,8,중문동,남성,5977,157,6134
2735,2020,8,중문동,여성,5590,155,5745
2736,2020,8,중앙동,남성,1707,36,1743
2737,2020,8,중앙동,여성,1888,45,1933
2738,2020,8,천지동,남성,1792,61,1853
2739,2020,8,천지동,여성,1769,47,1816
2740,2020,8,추자면,남성,901,264,1165
2741,2020,8,추자면,여성,780,13,793
2742,2020,8,표선면,남성,6319,255,6574
2743,2020,8,표선면,여성,5991,130,6121
2744,2020,8,한경면,남성,4577,269,4846
2745,2020,8,한경면,여성,4505,137,4642
2746,2020,8,한림읍,남성,10902,2257,13159
2747,2020,8,한림읍,여성,10327,1261,11588
2748,2020,8,화북동,남성,12270,206,12476
2749,2020,8,화북동,여성,12365,183,12548
2750,2020,8,효돈동,남성,2653,49,2702
2751,2020,8,효돈동,여성,2601,25,2626
2752,2020,9,건입동,남성,4637,147,4784
2753,2020,9,건입동,여성,4464,88,4552
2754,2020,9,구좌읍,남성,7986,409,8395
2755,2020,9,구좌읍,여성,7545,188,7733
2756,2020,9,남원읍,남성,9661,486,10147
2757,2020,9,남원읍,여성,9073,243,9316
2758,2020,9,노형동,남성,26750,1159,27909
2759,2020,9,노형동,여성,27748,1027,28775
2760,2020,9,대륜동,남성,7397,101,7498
2761,2020,9,대륜동,여성,7174,108,7282
2762,2020,9,대정읍,남성,10453,952,11405
2763,2020,9,대정읍,여성,11075,783,11858
2764,2020,9,대천동,남성,7016,80,7096
2765,2020,9,대천동,여성,6800,118,6918
2766,2020,9,도두동,남성,1706,59,1765
2767,2020,9,도두동,여성,1531,59,1590
2768,2020,9,동홍동,남성,11374,539,11913
2769,2020,9,동홍동,여성,11884,568,12452
2770,2020,9,봉개동,남성,2727,40,2767
2771,2020,9,봉개동,여성,2514,47,2561
2772,2020,9,삼도1동,남성,6662,59,6721
2773,2020,9,삼도1동,여성,6954,81,7035
2774,2020,9,삼도2동,남성,4174,158,4332
2775,2020,9,삼도2동,여성,3904,109,4013
2776,2020,9,삼양동,남성,12961,90,13051
2777,2020,9,삼양동,여성,12818,153,12971
2778,2020,9,서홍동,남성,5175,72,5247
2779,2020,9,서홍동,여성,5264,45,5309
2780,2020,9,성산읍,남성,7985,1129,9114
2781,2020,9,성산읍,여성,7312,563,7875
2782,2020,9,송산동,남성,2217,392,2609
2783,2020,9,송산동,여성,1985,127,2112
2784,2020,9,아라동,남성,18215,570,18785
2785,2020,9,아라동,여성,18375,548,18923
2786,2020,9,안덕면,남성,6186,291,6477
2787,2020,9,안덕면,여성,5822,282,6104
2788,2020,9,애월읍,남성,18959,508,19467
2789,2020,9,애월읍,여성,17851,470,18321
2790,2020,9,연동,남성,20464,982,21446
2791,2020,9,연동,여성,21250,1104,22354
2792,2020,9,영천동,남성,2658,125,2783
2793,2020,9,영천동,여성,2531,53,2584
2794,2020,9,예래동,남성,2027,122,2149
2795,2020,9,예래동,여성,1906,144,2050
2796,2020,9,오라동,남성,7949,108,8057
2797,2020,9,오라동,여성,7802,133,7935
2798,2020,9,외도동,남성,11031,119,11150
2799,2020,9,외도동,여성,10910,183,11093
2800,2020,9,용담1동,남성,3646,38,3684
2801,2020,9,용담1동,여성,3450,56,3506
2802,2020,9,용담2동,남성,7488,74,7562
2803,2020,9,용담2동,여성,7364,149,7513
2804,2020,9,우도면,남성,908,10,918
2805,2020,9,우도면,여성,844,14,858
2806,2020,9,이도1동,남성,3818,56,3874
2807,2020,9,이도1동,여성,3862,75,3937
2808,2020,9,이도2동,남성,24530,261,24791
2809,2020,9,이도2동,여성,25456,362,25818
2810,2020,9,이호동,남성,2378,86,2464
2811,2020,9,이호동,여성,2213,99,2312
2812,2020,9,일도1동,남성,1390,42,1432
2813,2020,9,일도1동,여성,1243,36,1279
2814,2020,9,일도2동,남성,16344,95,16439
2815,2020,9,일도2동,여성,16848,221,17069
2816,2020,9,정방동,남성,1117,61,1178
2817,2020,9,정방동,여성,1100,58,1158
2818,2020,9,조천읍,남성,12912,318,13230
2819,2020,9,조천읍,여성,12334,251,12585
2820,2020,9,중문동,남성,5977,150,6127
2821,2020,9,중문동,여성,5612,156,5768
2822,2020,9,중앙동,남성,1698,38,1736
2823,2020,9,중앙동,여성,1886,43,1929
2824,2020,9,천지동,남성,1785,60,1845
2825,2020,9,천지동,여성,1754,46,1800
2826,2020,9,추자면,남성,899,263,1162
2827,2020,9,추자면,여성,775,13,788
2828,2020,9,표선면,남성,6326,253,6579
2829,2020,9,표선면,여성,6020,128,6148
2830,2020,9,한경면,남성,4558,270,4828
2831,2020,9,한경면,여성,4494,135,4629
2832,2020,9,한림읍,남성,10891,2238,13129
2833,2020,9,한림읍,여성,10334,1248,11582
2834,2020,9,화북동,남성,12241,207,12448
2835,2020,9,화북동,여성,12339,182,12521
2836,2020,9,효돈동,남성,2656,47,2703
2837,2020,9,효돈동,여성,2596,26,2622
2838,2020,10,건입동,남성,4647,147,4794
2839,2020,10,건입동,여성,4463,92,4555
2840,2020,10,구좌읍,남성,8000,411,8411
2841,2020,10,구좌읍,여성,7546,184,7730
2842,2020,10,남원읍,남성,9666,477,10143
2843,2020,10,남원읍,여성,9078,238,9316
2844,2020,10,노형동,남성,26850,1153,28003
2845,2020,10,노형동,여성,27889,1008,28897
2846,2020,10,대륜동,남성,7409,107,7516
2847,2020,10,대륜동,여성,7216,99,7315
2848,2020,10,대정읍,남성,10495,946,11441
2849,2020,10,대정읍,여성,11121,774,11895
2850,2020,10,대천동,남성,7055,81,7136
2851,2020,10,대천동,여성,6835,117,6952
2852,2020,10,도두동,남성,1705,56,1761
2853,2020,10,도두동,여성,1539,55,1594
2854,2020,10,동홍동,남성,11357,505,11862
2855,2020,10,동홍동,여성,11876,542,12418
2856,2020,10,봉개동,남성,2727,39,2766
2857,2020,10,봉개동,여성,2518,46,2564
2858,2020,10,삼도1동,남성,6656,55,6711
2859,2020,10,삼도1동,여성,6933,80,7013
2860,2020,10,삼도2동,남성,4183,152,4335
2861,2020,10,삼도2동,여성,3894,109,4003
2862,2020,10,삼양동,남성,12946,88,13034
2863,2020,10,삼양동,여성,12831,155,12986
2864,2020,10,서홍동,남성,5235,72,5307
2865,2020,10,서홍동,여성,5318,50,5368
2866,2020,10,성산읍,남성,7988,1117,9105
2867,2020,10,성산읍,여성,7300,563,7863
2868,2020,10,송산동,남성,2207,375,2582
2869,2020,10,송산동,여성,1967,116,2083
2870,2020,10,아라동,남성,18285,565,18850
2871,2020,10,아라동,여성,18491,528,19019
2872,2020,10,안덕면,남성,6162,270,6432
2873,2020,10,안덕면,여성,5803,278,6081
2874,2020,10,애월읍,남성,18959,511,19470
2875,2020,10,애월읍,여성,17840,477,18317
2876,2020,10,연동,남성,20512,961,21473
2877,2020,10,연동,여성,21284,1101,22385
2878,2020,10,영천동,남성,2663,126,2789
2879,2020,10,영천동,여성,2525,49,2574
2880,2020,10,예래동,남성,2025,118,2143
2881,2020,10,예래동,여성,1913,141,2054
2882,2020,10,오라동,남성,7949,102,8051
2883,2020,10,오라동,여성,7808,129,7937
2884,2020,10,외도동,남성,11040,115,11155
2885,2020,10,외도동,여성,10917,183,11100
2886,2020,10,용담1동,남성,3640,38,3678
2887,2020,10,용담1동,여성,3443,54,3497
2888,2020,10,용담2동,남성,7462,71,7533
2889,2020,10,용담2동,여성,7358,144,7502
2890,2020,10,우도면,남성,909,10,919
2891,2020,10,우도면,여성,841,13,854
2892,2020,10,이도1동,남성,3818,55,3873
2893,2020,10,이도1동,여성,3856,70,3926
2894,2020,10,이도2동,남성,24541,256,24797
2895,2020,10,이도2동,여성,25465,358,25823
2896,2020,10,이호동,남성,2377,87,2464
2897,2020,10,이호동,여성,2219,97,2316
2898,2020,10,일도1동,남성,1372,45,1417
2899,2020,10,일도1동,여성,1243,34,1277
2900,2020,10,일도2동,남성,16330,91,16421
2901,2020,10,일도2동,여성,16858,214,17072
2902,2020,10,정방동,남성,1116,62,1178
2903,2020,10,정방동,여성,1095,57,1152
2904,2020,10,조천읍,남성,12935,313,13248
2905,2020,10,조천읍,여성,12360,255,12615
2906,2020,10,중문동,남성,5955,149,6104
2907,2020,10,중문동,여성,5599,155,5754
2908,2020,10,중앙동,남성,1690,37,1727
2909,2020,10,중앙동,여성,1873,42,1915
2910,2020,10,천지동,남성,1773,60,1833
2911,2020,10,천지동,여성,1753,50,1803
2912,2020,10,추자면,남성,900,265,1165
2913,2020,10,추자면,여성,769,13,782
2914,2020,10,표선면,남성,6328,249,6577
2915,2020,10,표선면,여성,6016,129,6145
2916,2020,10,한경면,남성,4555,269,4824
2917,2020,10,한경면,여성,4494,135,4629
2918,2020,10,한림읍,남성,10900,2209,13109
2919,2020,10,한림읍,여성,10346,1212,11558
2920,2020,10,화북동,남성,12214,198,12412
2921,2020,10,화북동,여성,12332,178,12510
2922,2020,10,효돈동,남성,2654,47,2701
2923,2020,10,효돈동,여성,2591,26,2617
2924,2020,11,건입동,남성,4646,145,4791
2925,2020,11,건입동,여성,4455,91,4546
2926,2020,11,구좌읍,남성,8000,415,8415
2927,2020,11,구좌읍,여성,7557,181,7738
2928,2020,11,남원읍,남성,9684,476,10160
2929,2020,11,남원읍,여성,9073,239,9312
2930,2020,11,노형동,남성,26927,1139,28066
2931,2020,11,노형동,여성,27968,999,28967
2932,2020,11,대륜동,남성,7411,102,7513
2933,2020,11,대륜동,여성,7241,100,7341
2934,2020,11,대정읍,남성,10533,939,11472
2935,2020,11,대정읍,여성,11187,769,11956
2936,2020,11,대천동,남성,7122,79,7201
2937,2020,11,대천동,여성,6864,118,6982
2938,2020,11,도두동,남성,1716,56,1772
2939,2020,11,도두동,여성,1539,54,1593
2940,2020,11,동홍동,남성,11347,482,11829
2941,2020,11,동홍동,여성,11890,518,12408
2942,2020,11,봉개동,남성,2724,35,2759
2943,2020,11,봉개동,여성,2515,46,2561
2944,2020,11,삼도1동,남성,6654,53,6707
2945,2020,11,삼도1동,여성,6942,79,7021
2946,2020,11,삼도2동,남성,4177,151,4328
2947,2020,11,삼도2동,여성,3875,105,3980
2948,2020,11,삼양동,남성,12933,87,13020
2949,2020,11,삼양동,여성,12832,150,12982
2950,2020,11,서홍동,남성,5240,74,5314
2951,2020,11,서홍동,여성,5346,50,5396
2952,2020,11,성산읍,남성,8004,1108,9112
2953,2020,11,성산읍,여성,7302,561,7863
2954,2020,11,송산동,남성,2213,368,2581
2955,2020,11,송산동,여성,1962,115,2077
2956,2020,11,아라동,남성,18333,565,18898
2957,2020,11,아라동,여성,18579,530,19109
2958,2020,11,안덕면,남성,6174,264,6438
2959,2020,11,안덕면,여성,5806,274,6080
2960,2020,11,애월읍,남성,18992,509,19501
2961,2020,11,애월읍,여성,17850,480,18330
2962,2020,11,연동,남성,20487,953,21440
2963,2020,11,연동,여성,21314,1092,22406
2964,2020,11,영천동,남성,2667,124,2791
2965,2020,11,영천동,여성,2540,49,2589
2966,2020,11,예래동,남성,2025,117,2142
2967,2020,11,예래동,여성,1919,140,2059
2968,2020,11,오라동,남성,7934,99,8033
2969,2020,11,오라동,여성,7804,125,7929
2970,2020,11,외도동,남성,11057,117,11174
2971,2020,11,외도동,여성,10957,182,11139
2972,2020,11,용담1동,남성,3632,39,3671
2973,2020,11,용담1동,여성,3440,52,3492
2974,2020,11,용담2동,남성,7453,72,7525
2975,2020,11,용담2동,여성,7339,146,7485
2976,2020,11,우도면,남성,910,10,920
2977,2020,11,우도면,여성,843,13,856
2978,2020,11,이도1동,남성,3820,55,3875
2979,2020,11,이도1동,여성,3850,70,3920
2980,2020,11,이도2동,남성,24512,249,24761
2981,2020,11,이도2동,여성,25435,353,25788
2982,2020,11,이호동,남성,2375,85,2460
2983,2020,11,이호동,여성,2198,100,2298
2984,2020,11,일도1동,남성,1372,48,1420
2985,2020,11,일도1동,여성,1241,34,1275
2986,2020,11,일도2동,남성,16297,84,16381
2987,2020,11,일도2동,여성,16821,211,17032
2988,2020,11,정방동,남성,1113,61,1174
2989,2020,11,정방동,여성,1090,58,1148
2990,2020,11,조천읍,남성,12950,316,13266
2991,2020,11,조천읍,여성,12378,259,12637
2992,2020,11,중문동,남성,5955,148,6103
2993,2020,11,중문동,여성,5596,149,5745
2994,2020,11,중앙동,남성,1677,36,1713
2995,2020,11,중앙동,여성,1856,41,1897
2996,2020,11,천지동,남성,1773,60,1833
2997,2020,11,천지동,여성,1750,50,1800
2998,2020,11,추자면,남성,901,263,1164
2999,2020,11,추자면,여성,770,13,783
3000,2020,11,표선면,남성,6313,245,6558
3001,2020,11,표선면,여성,6021,128,6149
3002,2020,11,한경면,남성,4538,265,4803
3003,2020,11,한경면,여성,4481,130,4611
3004,2020,11,한림읍,남성,10893,2190,13083
3005,2020,11,한림읍,여성,10355,1189,11544
3006,2020,11,화북동,남성,12174,193,12367
3007,2020,11,화북동,여성,12327,176,12503
3008,2020,11,효돈동,남성,2654,48,2702
3009,2020,11,효돈동,여성,2581,25,2606
3010,2020,12,건입동,남성,4641,145,4786
3011,2020,12,건입동,여성,4450,89,4539
3012,2020,12,구좌읍,남성,7991,406,8397
3013,2020,12,구좌읍,여성,7555,177,7732
3014,2020,12,남원읍,남성,9698,468,10166
3015,2020,12,남원읍,여성,9068,235,9303
3016,2020,12,노형동,남성,27019,1128,28147
3017,2020,12,노형동,여성,28068,975,29043
3018,2020,12,대륜동,남성,7464,100,7564
3019,2020,12,대륜동,여성,7301,98,7399
3020,2020,12,대정읍,남성,10555,926,11481
3021,2020,12,대정읍,여성,11206,764,11970
3022,2020,12,대천동,남성,7100,76,7176
3023,2020,12,대천동,여성,6821,113,6934
3024,2020,12,도두동,남성,1714,52,1766
3025,2020,12,도두동,여성,1548,53,1601
3026,2020,12,동홍동,남성,11351,477,11828
3027,2020,12,동홍동,여성,11882,512,12394
3028,2020,12,봉개동,남성,2747,38,2785
3029,2020,12,봉개동,여성,2538,49,2587
3030,2020,12,삼도1동,남성,6646,52,6698
3031,2020,12,삼도1동,여성,6940,81,7021
3032,2020,12,삼도2동,남성,4149,156,4305
3033,2020,12,삼도2동,여성,3856,114,3970
3034,2020,12,삼양동,남성,12974,90,13064
3035,2020,12,삼양동,여성,12863,152,13015
3036,2020,12,서홍동,남성,5251,76,5327
3037,2020,12,서홍동,여성,5367,52,5419
3038,2020,12,성산읍,남성,8058,1108,9166
3039,2020,12,성산읍,여성,7354,552,7906
3040,2020,12,송산동,남성,2202,377,2579
3041,2020,12,송산동,여성,1969,110,2079
3042,2020,12,아라동,남성,18421,554,18975
3043,2020,12,아라동,여성,18649,513,19162
3044,2020,12,안덕면,남성,6174,266,6440
3045,2020,12,안덕면,여성,5808,275,6083
3046,2020,12,애월읍,남성,19025,504,19529
3047,2020,12,애월읍,여성,17888,481,18369
3048,2020,12,연동,남성,20519,935,21454
3049,2020,12,연동,여성,21391,1071,22462
3050,2020,12,영천동,남성,2661,125,2786
3051,2020,12,영천동,여성,2538,47,2585
3052,2020,12,예래동,남성,2022,120,2142
3053,2020,12,예래동,여성,1916,142,2058
3054,2020,12,오라동,남성,7956,97,8053
3055,2020,12,오라동,여성,7790,123,7913
3056,2020,12,외도동,남성,11059,116,11175
3057,2020,12,외도동,여성,10996,182,11178
3058,2020,12,용담1동,남성,3609,38,3647
3059,2020,12,용담1동,여성,3441,52,3493
3060,2020,12,용담2동,남성,7458,69,7527
3061,2020,12,용담2동,여성,7340,147,7487
3062,2020,12,우도면,남성,908,11,919
3063,2020,12,우도면,여성,832,15,847
3064,2020,12,이도1동,남성,3826,54,3880
3065,2020,12,이도1동,여성,3857,71,3928
3066,2020,12,이도2동,남성,24446,248,24694
3067,2020,12,이도2동,여성,25388,341,25729
3068,2020,12,이호동,남성,2386,81,2467
3069,2020,12,이호동,여성,2186,93,2279
3070,2020,12,일도1동,남성,1362,48,1410
3071,2020,12,일도1동,여성,1222,32,1254
3072,2020,12,일도2동,남성,16280,83,16363
3073,2020,12,일도2동,여성,16782,208,16990
3074,2020,12,정방동,남성,1109,60,1169
3075,2020,12,정방동,여성,1087,59,1146
3076,2020,12,조천읍,남성,12958,310,13268
3077,2020,12,조천읍,여성,12381,256,12637
3078,2020,12,중문동,남성,5975,148,6123
3079,2020,12,중문동,여성,5611,143,5754
3080,2020,12,중앙동,남성,1668,35,1703
3081,2020,12,중앙동,여성,1851,38,1889
3082,2020,12,천지동,남성,1772,61,1833
3083,2020,12,천지동,여성,1752,51,1803
3084,2020,12,추자면,남성,903,274,1177
3085,2020,12,추자면,여성,774,12,786
3086,2020,12,표선면,남성,6306,241,6547
3087,2020,12,표선면,여성,6019,125,6144
3088,2020,12,한경면,남성,4555,264,4819
3089,2020,12,한경면,여성,4474,129,4603
3090,2020,12,한림읍,남성,10886,2184,13070
3091,2020,12,한림읍,여성,10363,1176,11539
3092,2020,12,화북동,남성,12150,191,12341
3093,2020,12,화북동,여성,12306,172,12478
3094,2020,12,효돈동,남성,2655,48,2703
3095,2020,12,효돈동,여성,2598,23,2621
3096,2021,1,건입동,남성,4610,149,4759
3097,2021,1,건입동,여성,4432,88,4520
3098,2021,1,구좌읍,남성,7970,409,8379
3099,2021,1,구좌읍,여성,7542,178,7720
3100,2021,1,남원읍,남성,9689,463,10152
3101,2021,1,남원읍,여성,9067,233,9300
3102,2021,1,노형동,남성,27033,1117,28150
3103,2021,1,노형동,여성,28073,960,29033
3104,2021,1,대륜동,남성,7515,100,7615
3105,2021,1,대륜동,여성,7311,96,7407
3106,2021,1,대정읍,남성,10597,918,11515
3107,2021,1,대정읍,여성,11219,769,11988
3108,2021,1,대천동,남성,7083,73,7156
3109,2021,1,대천동,여성,6817,110,6927
3110,2021,1,도두동,남성,1724,52,1776
3111,2021,1,도두동,여성,1546,48,1594
3112,2021,1,동홍동,남성,11334,471,11805
3113,2021,1,동홍동,여성,11853,508,12361
3114,2021,1,봉개동,남성,2752,38,2790
3115,2021,1,봉개동,여성,2535,47,2582
3116,2021,1,삼도1동,남성,6646,53,6699
3117,2021,1,삼도1동,여성,6933,83,7016
3118,2021,1,삼도2동,남성,4126,154,4280
3119,2021,1,삼도2동,여성,3823,110,3933
3120,2021,1,삼양동,남성,12962,85,13047
3121,2021,1,삼양동,여성,12882,150,13032
3122,2021,1,서홍동,남성,5313,77,5390
3123,2021,1,서홍동,여성,5430,54,5484
3124,2021,1,성산읍,남성,8045,1109,9154
3125,2021,1,성산읍,여성,7352,547,7899
3126,2021,1,송산동,남성,2176,372,2548
3127,2021,1,송산동,여성,1969,106,2075
3128,2021,1,아라동,남성,18592,546,19138
3129,2021,1,아라동,여성,18824,499,19323
3130,2021,1,안덕면,남성,6208,262,6470
3131,2021,1,안덕면,여성,5826,272,6098
3132,2021,1,애월읍,남성,19026,489,19515
3133,2021,1,애월읍,여성,17910,479,18389
3134,2021,1,연동,남성,20506,930,21436
3135,2021,1,연동,여성,21402,1061,22463
3136,2021,1,영천동,남성,2647,124,2771
3137,2021,1,영천동,여성,2528,47,2575
3138,2021,1,예래동,남성,2018,120,2138
3139,2021,1,예래동,여성,1916,138,2054
3140,2021,1,오라동,남성,7955,98,8053
3141,2021,1,오라동,여성,7758,130,7888
3142,2021,1,외도동,남성,11078,113,11191
3143,2021,1,외도동,여성,11013,179,11192
3144,2021,1,용담1동,남성,3578,36,3614
3145,2021,1,용담1동,여성,3413,51,3464
3146,2021,1,용담2동,남성,7437,66,7503
3147,2021,1,용담2동,여성,7312,142,7454
3148,2021,1,우도면,남성,906,12,918
3149,2021,1,우도면,여성,835,14,849
3150,2021,1,이도1동,남성,3793,53,3846
3151,2021,1,이도1동,여성,3842,70,3912
3152,2021,1,이도2동,남성,24431,247,24678
3153,2021,1,이도2동,여성,25370,334,25704
3154,2021,1,이호동,남성,2378,86,2464
3155,2021,1,이호동,여성,2186,90,2276
3156,2021,1,일도1동,남성,1347,47,1394
3157,2021,1,일도1동,여성,1214,32,1246
3158,2021,1,일도2동,남성,16179,81,16260
3159,2021,1,일도2동,여성,16709,206,16915
3160,2021,1,정방동,남성,1101,60,1161
3161,2021,1,정방동,여성,1083,58,1141
3162,2021,1,조천읍,남성,12963,309,13272
3163,2021,1,조천읍,여성,12398,249,12647
3164,2021,1,중문동,남성,5946,144,6090
3165,2021,1,중문동,여성,5597,143,5740
3166,2021,1,중앙동,남성,1660,35,1695
3167,2021,1,중앙동,여성,1843,38,1881
3168,2021,1,천지동,남성,1771,60,1831
3169,2021,1,천지동,여성,1744,50,1794
3170,2021,1,추자면,남성,891,261,1152
3171,2021,1,추자면,여성,772,12,784
3172,2021,1,표선면,남성,6309,238,6547
3173,2021,1,표선면,여성,6030,123,6153
3174,2021,1,한경면,남성,4554,261,4815
3175,2021,1,한경면,여성,4487,128,4615
3176,2021,1,한림읍,남성,10889,2182,13071
3177,2021,1,한림읍,여성,10374,1171,11545
3178,2021,1,화북동,남성,12148,193,12341
3179,2021,1,화북동,여성,12287,171,12458
3180,2021,1,효돈동,남성,2667,45,2712
3181,2021,1,효돈동,여성,2605,22,2627
3182,2021,2,건입동,남성,4577,146,4723
3183,2021,2,건입동,여성,4407,85,4492
3184,2021,2,구좌읍,남성,7979,402,8381
3185,2021,2,구좌읍,여성,7551,181,7732
3186,2021,2,남원읍,남성,9687,456,10143
3187,2021,2,남원읍,여성,9064,230,9294
3188,2021,2,노형동,남성,27043,1114,28157
3189,2021,2,노형동,여성,28103,943,29046
3190,2021,2,대륜동,남성,7553,95,7648
3191,2021,2,대륜동,여성,7353,96,7449
3192,2021,2,대정읍,남성,10651,922,11573
3193,2021,2,대정읍,여성,11296,774,12070
3194,2021,2,대천동,남성,7068,72,7140
3195,2021,2,대천동,여성,6841,109,6950
3196,2021,2,도두동,남성,1719,50,1769
3197,2021,2,도두동,여성,1545,48,1593
3198,2021,2,동홍동,남성,11320,460,11780
3199,2021,2,동홍동,여성,11899,491,12390
3200,2021,2,봉개동,남성,2762,37,2799
3201,2021,2,봉개동,여성,2545,45,2590
3202,2021,2,삼도1동,남성,6641,53,6694
3203,2021,2,삼도1동,여성,6928,84,7012
3204,2021,2,삼도2동,남성,4126,151,4277
3205,2021,2,삼도2동,여성,3821,108,3929
3206,2021,2,삼양동,남성,12961,83,13044
3207,2021,2,삼양동,여성,12891,149,13040
3208,2021,2,서홍동,남성,5336,75,5411
3209,2021,2,서홍동,여성,5436,53,5489
3210,2021,2,성산읍,남성,8055,1105,9160
3211,2021,2,성산읍,여성,7348,545,7893
3212,2021,2,송산동,남성,2171,362,2533
3213,2021,2,송산동,여성,1946,104,2050
3214,2021,2,아라동,남성,18768,539,19307
3215,2021,2,아라동,여성,19068,474,19542
3216,2021,2,안덕면,남성,6214,263,6477
3217,2021,2,안덕면,여성,5835,266,6101
3218,2021,2,애월읍,남성,19017,472,19489
3219,2021,2,애월읍,여성,17989,478,18467
3220,2021,2,연동,남성,20510,928,21438
3221,2021,2,연동,여성,21416,1054,22470
3222,2021,2,영천동,남성,2640,120,2760
3223,2021,2,영천동,여성,2542,46,2588
3224,2021,2,예래동,남성,2013,119,2132
3225,2021,2,예래동,여성,1904,137,2041
3226,2021,2,오라동,남성,7972,97,8069
3227,2021,2,오라동,여성,7780,130,7910
3228,2021,2,외도동,남성,11061,111,11172
3229,2021,2,외도동,여성,10997,176,11173
3230,2021,2,용담1동,남성,3581,36,3617
3231,2021,2,용담1동,여성,3412,51,3463
3232,2021,2,용담2동,남성,7437,67,7504
3233,2021,2,용담2동,여성,7265,142,7407
3234,2021,2,우도면,남성,910,12,922
3235,2021,2,우도면,여성,836,14,850
3236,2021,2,이도1동,남성,3768,53,3821
3237,2021,2,이도1동,여성,3804,72,3876
3238,2021,2,이도2동,남성,24314,249,24563
3239,2021,2,이도2동,여성,25324,328,25652
3240,2021,2,이호동,남성,2370,85,2455
3241,2021,2,이호동,여성,2184,84,2268
3242,2021,2,일도1동,남성,1339,46,1385
3243,2021,2,일도1동,여성,1205,35,1240
3244,2021,2,일도2동,남성,16176,82,16258
3245,2021,2,일도2동,여성,16714,200,16914
3246,2021,2,정방동,남성,1093,64,1157
3247,2021,2,정방동,여성,1064,56,1120
3248,2021,2,조천읍,남성,12980,299,13279
3249,2021,2,조천읍,여성,12427,246,12673
3250,2021,2,중문동,남성,5938,146,6084
3251,2021,2,중문동,여성,5601,144,5745
3252,2021,2,중앙동,남성,1648,32,1680
3253,2021,2,중앙동,여성,1819,39,1858
3254,2021,2,천지동,남성,1779,59,1838
3255,2021,2,천지동,여성,1724,50,1774
3256,2021,2,추자면,남성,891,255,1146
3257,2021,2,추자면,여성,762,12,774
3258,2021,2,표선면,남성,6316,236,6552
3259,2021,2,표선면,여성,6041,126,6167
3260,2021,2,한경면,남성,4566,260,4826
3261,2021,2,한경면,여성,4510,127,4637
3262,2021,2,한림읍,남성,10896,2147,13043
3263,2021,2,한림읍,여성,10371,1157,11528
3264,2021,2,화북동,남성,12154,186,12340
3265,2021,2,화북동,여성,12280,171,12451
3266,2021,2,효돈동,남성,2673,44,2717
3267,2021,2,효돈동,여성,2616,21,2637
3268,2021,3,건입동,남성,4527,144,4671
3269,2021,3,건입동,여성,4390,87,4477
3270,2021,3,구좌읍,남성,7925,399,8324
3271,2021,3,구좌읍,여성,7487,174,7661
3272,2021,3,남원읍,남성,9666,452,10118
3273,2021,3,남원읍,여성,9038,228,9266
3274,2021,3,노형동,남성,27009,1122,28131
3275,2021,3,노형동,여성,28074,950,29024
3276,2021,3,대륜동,남성,7568,93,7661
3277,2021,3,대륜동,여성,7390,95,7485
3278,2021,3,대정읍,남성,10628,915,11543
3279,2021,3,대정읍,여성,11255,772,12027
3280,2021,3,대천동,남성,7054,77,7131
3281,2021,3,대천동,여성,6804,113,6917
3282,2021,3,도두동,남성,1719,50,1769
3283,2021,3,도두동,여성,1551,47,1598
3284,2021,3,동홍동,남성,11328,455,11783
3285,2021,3,동홍동,여성,11875,487,12362
3286,2021,3,봉개동,남성,2754,36,2790
3287,2021,3,봉개동,여성,2527,45,2572
3288,2021,3,삼도1동,남성,6616,51,6667
3289,2021,3,삼도1동,여성,6907,84,6991
3290,2021,3,삼도2동,남성,4123,151,4274
3291,2021,3,삼도2동,여성,3818,109,3927
3292,2021,3,삼양동,남성,12933,76,13009
3293,2021,3,삼양동,여성,12837,148,12985
3294,2021,3,서홍동,남성,5314,68,5382
3295,2021,3,서홍동,여성,5443,53,5496
3296,2021,3,성산읍,남성,8081,1091,9172
3297,2021,3,성산읍,여성,7338,536,7874
3298,2021,3,송산동,남성,2145,356,2501
3299,2021,3,송산동,여성,1916,106,2022
3300,2021,3,아라동,남성,18844,548,19392
3301,2021,3,아라동,여성,19228,481,19709
3302,2021,3,안덕면,남성,6240,257,6497
3303,2021,3,안덕면,여성,5855,268,6123
3304,2021,3,애월읍,남성,19027,467,19494
3305,2021,3,애월읍,여성,18045,476,18521
3306,2021,3,연동,남성,20535,909,21444
3307,2021,3,연동,여성,21414,1043,22457
3308,2021,3,영천동,남성,2630,118,2748
3309,2021,3,영천동,여성,2535,46,2581
3310,2021,3,예래동,남성,2007,116,2123
3311,2021,3,예래동,여성,1918,137,2055
3312,2021,3,오라동,남성,7999,94,8093
3313,2021,3,오라동,여성,7767,126,7893
3314,2021,3,외도동,남성,11027,110,11137
3315,2021,3,외도동,여성,10976,177,11153
3316,2021,3,용담1동,남성,3565,35,3600
3317,2021,3,용담1동,여성,3374,50,3424
3318,2021,3,용담2동,남성,7426,67,7493
3319,2021,3,용담2동,여성,7200,137,7337
3320,2021,3,우도면,남성,907,13,920
3321,2021,3,우도면,여성,827,14,841
3322,2021,3,이도1동,남성,3743,55,3798
3323,2021,3,이도1동,여성,3791,72,3863
3324,2021,3,이도2동,남성,24287,246,24533
3325,2021,3,이도2동,여성,25254,332,25586
3326,2021,3,이호동,남성,2371,85,2456
3327,2021,3,이호동,여성,2192,82,2274
3328,2021,3,일도1동,남성,1316,46,1362
3329,2021,3,일도1동,여성,1169,34,1203
3330,2021,3,일도2동,남성,16107,82,16189
3331,2021,3,일도2동,여성,16607,197,16804
3332,2021,3,정방동,남성,1078,62,1140
3333,2021,3,정방동,여성,1044,55,1099
3334,2021,3,조천읍,남성,12960,288,13248
3335,2021,3,조천읍,여성,12364,246,12610
3336,2021,3,중문동,남성,5942,147,6089
3337,2021,3,중문동,여성,5602,143,5745
3338,2021,3,중앙동,남성,1617,31,1648
3339,2021,3,중앙동,여성,1788,40,1828
3340,2021,3,천지동,남성,1750,58,1808
3341,2021,3,천지동,여성,1713,50,1763
3342,2021,3,추자면,남성,878,254,1132
3343,2021,3,추자면,여성,758,11,769
3344,2021,3,표선면,남성,6302,235,6537
3345,2021,3,표선면,여성,6005,121,6126
3346,2021,3,한경면,남성,4564,258,4822
3347,2021,3,한경면,여성,4488,126,4614
3348,2021,3,한림읍,남성,10906,2128,13034
3349,2021,3,한림읍,여성,10308,1152,11460
3350,2021,3,화북동,남성,12135,178,12313
3351,2021,3,화북동,여성,12287,165,12452
3352,2021,3,효돈동,남성,2653,41,2694
3353,2021,3,효돈동,여성,2609,20,2629
3354,2021,4,건입동,남성,4538,140,4678
3355,2021,4,건입동,여성,4384,86,4470
3356,2021,4,구좌읍,남성,7930,392,8322
3357,2021,4,구좌읍,여성,7495,174,7669
3358,2021,4,남원읍,남성,9685,440,10125
3359,2021,4,남원읍,여성,9044,221,9265
3360,2021,4,노형동,남성,27056,1135,28191
3361,2021,4,노형동,여성,28166,955,29121
3362,2021,4,대륜동,남성,7619,95,7714
3363,2021,4,대륜동,여성,7414,95,7509
3364,2021,4,대정읍,남성,10622,909,11531
3365,2021,4,대정읍,여성,11237,773,12010
3366,2021,4,대천동,남성,7064,76,7140
3367,2021,4,대천동,여성,6814,111,6925
3368,2021,4,도두동,남성,1726,50,1776
3369,2021,4,도두동,여성,1557,48,1605
3370,2021,4,동홍동,남성,11321,437,11758
3371,2021,4,동홍동,여성,11872,474,12346
3372,2021,4,봉개동,남성,2744,36,2780
3373,2021,4,봉개동,여성,2527,46,2573
3374,2021,4,삼도1동,남성,6617,51,6668
3375,2021,4,삼도1동,여성,6886,83,6969
3376,2021,4,삼도2동,남성,4101,145,4246
3377,2021,4,삼도2동,여성,3822,103,3925
3378,2021,4,삼양동,남성,12938,79,13017
3379,2021,4,삼양동,여성,12829,147,12976
3380,2021,4,서홍동,남성,5342,72,5414
3381,2021,4,서홍동,여성,5468,55,5523
3382,2021,4,성산읍,남성,8083,1050,9133
3383,2021,4,성산읍,여성,7354,512,7866
3384,2021,4,송산동,남성,2149,353,2502
3385,2021,4,송산동,여성,1912,104,2016
3386,2021,4,아라동,남성,18889,558,19447
3387,2021,4,아라동,여성,19287,479,19766
3388,2021,4,안덕면,남성,6261,251,6512
3389,2021,4,안덕면,여성,5860,268,6128
3390,2021,4,애월읍,남성,19031,462,19493
3391,2021,4,애월읍,여성,18096,491,18587
3392,2021,4,연동,남성,20534,894,21428
3393,2021,4,연동,여성,21415,1040,22455
3394,2021,4,영천동,남성,2622,116,2738
3395,2021,4,영천동,여성,2529,47,2576
3396,2021,4,예래동,남성,2004,118,2122
3397,2021,4,예래동,여성,1904,135,2039
3398,2021,4,오라동,남성,8002,93,8095
3399,2021,4,오라동,여성,7788,124,7912
3400,2021,4,외도동,남성,11021,98,11119
3401,2021,4,외도동,여성,10961,173,11134
3402,2021,4,용담1동,남성,3579,32,3611
3403,2021,4,용담1동,여성,3383,53,3436
3404,2021,4,용담2동,남성,7426,68,7494
3405,2021,4,용담2동,여성,7199,138,7337
3406,2021,4,우도면,남성,897,13,910
3407,2021,4,우도면,여성,825,14,839
3408,2021,4,이도1동,남성,3744,56,3800
3409,2021,4,이도1동,여성,3797,73,3870
3410,2021,4,이도2동,남성,24287,244,24531
3411,2021,4,이도2동,여성,25268,334,25602
3412,2021,4,이호동,남성,2372,83,2455
3413,2021,4,이호동,여성,2196,81,2277
3414,2021,4,일도1동,남성,1301,46,1347
3415,2021,4,일도1동,여성,1163,34,1197
3416,2021,4,일도2동,남성,16089,80,16169
3417,2021,4,일도2동,여성,16589,202,16791
3418,2021,4,정방동,남성,1074,63,1137
3419,2021,4,정방동,여성,1052,51,1103
3420,2021,4,조천읍,남성,12990,282,13272
3421,2021,4,조천읍,여성,12390,244,12634
3422,2021,4,중문동,남성,5956,151,6107
3423,2021,4,중문동,여성,5617,152,5769
3424,2021,4,중앙동,남성,1614,32,1646
3425,2021,4,중앙동,여성,1769,41,1810
3426,2021,4,천지동,남성,1746,58,1804
3427,2021,4,천지동,여성,1707,51,1758
3428,2021,4,추자면,남성,872,252,1124
3429,2021,4,추자면,여성,760,10,770
3430,2021,4,표선면,남성,6313,229,6542
3431,2021,4,표선면,여성,6021,121,6142
3432,2021,4,한경면,남성,4585,250,4835
3433,2021,4,한경면,여성,4512,118,4630
3434,2021,4,한림읍,남성,10906,2114,13020
3435,2021,4,한림읍,여성,10318,1149,11467
3436,2021,4,화북동,남성,12112,174,12286
3437,2021,4,화북동,여성,12268,162,12430
3438,2021,4,효돈동,남성,2660,40,2700
3439,2021,4,효돈동,여성,2607,19,2626
3440,2021,5,건입동,남성,4520,139,4659
3441,2021,5,건입동,여성,4380,88,4468
3442,2021,5,구좌읍,남성,7915,390,8305
3443,2021,5,구좌읍,여성,7487,171,7658
3444,2021,5,남원읍,남성,9662,438,10100
3445,2021,5,남원읍,여성,9040,216,9256
3446,2021,5,노형동,남성,27126,1135,28261
3447,2021,5,노형동,여성,28200,934,29134
3448,2021,5,대륜동,남성,7628,91,7719
3449,2021,5,대륜동,여성,7424,96,7520
3450,2021,5,대정읍,남성,10659,910,11569
3451,2021,5,대정읍,여성,11260,768,12028
3452,2021,5,대천동,남성,7083,73,7156
3453,2021,5,대천동,여성,6825,111,6936
3454,2021,5,도두동,남성,1724,49,1773
3455,2021,5,도두동,여성,1567,45,1612
3456,2021,5,동홍동,남성,11308,438,11746
3457,2021,5,동홍동,여성,11896,469,12365
3458,2021,5,봉개동,남성,2731,36,2767
3459,2021,5,봉개동,여성,2524,46,2570
3460,2021,5,삼도1동,남성,6630,52,6682
3461,2021,5,삼도1동,여성,6895,86,6981
3462,2021,5,삼도2동,남성,4114,145,4259
3463,2021,5,삼도2동,여성,3829,106,3935
3464,2021,5,삼양동,남성,12950,78,13028
3465,2021,5,삼양동,여성,12853,147,13000
3466,2021,5,서홍동,남성,5359,73,5432
3467,2021,5,서홍동,여성,5487,54,5541
3468,2021,5,성산읍,남성,8088,1035,9123
3469,2021,5,성산읍,여성,7360,490,7850
3470,2021,5,송산동,남성,2142,358,2500
3471,2021,5,송산동,여성,1901,104,2005
3472,2021,5,아라동,남성,18899,566,19465
3473,2021,5,아라동,여성,19344,476,19820
3474,2021,5,안덕면,남성,6285,246,6531
3475,2021,5,안덕면,여성,5879,264,6143
3476,2021,5,애월읍,남성,19075,472,19547
3477,2021,5,애월읍,여성,18148,502,18650
3478,2021,5,연동,남성,20541,886,21427
3479,2021,5,연동,여성,21412,1025,22437
3480,2021,5,영천동,남성,2606,114,2720
3481,2021,5,영천동,여성,2527,46,2573
3482,2021,5,예래동,남성,2021,112,2133
3483,2021,5,예래동,여성,1910,135,2045
3484,2021,5,오라동,남성,7995,90,8085
3485,2021,5,오라동,여성,7805,130,7935
3486,2021,5,외도동,남성,11045,100,11145
3487,2021,5,외도동,여성,10986,176,11162
3488,2021,5,용담1동,남성,3576,31,3607
3489,2021,5,용담1동,여성,3377,53,3430
3490,2021,5,용담2동,남성,7423,69,7492
3491,2021,5,용담2동,여성,7170,134,7304
3492,2021,5,우도면,남성,895,13,908
3493,2021,5,우도면,여성,824,14,838
3494,2021,5,이도1동,남성,3715,54,3769
3495,2021,5,이도1동,여성,3794,73,3867
3496,2021,5,이도2동,남성,24301,245,24546
3497,2021,5,이도2동,여성,25258,330,25588
3498,2021,5,이호동,남성,2358,83,2441
3499,2021,5,이호동,여성,2176,75,2251
3500,2021,5,일도1동,남성,1301,44,1345
3501,2021,5,일도1동,여성,1153,35,1188
3502,2021,5,일도2동,남성,16089,76,16165
3503,2021,5,일도2동,여성,16582,201,16783
3504,2021,5,정방동,남성,1078,63,1141
3505,2021,5,정방동,여성,1058,50,1108
3506,2021,5,조천읍,남성,13002,278,13280
3507,2021,5,조천읍,여성,12425,245,12670
3508,2021,5,중문동,남성,5930,156,6086
3509,2021,5,중문동,여성,5626,153,5779
3510,2021,5,중앙동,남성,1614,31,1645
3511,2021,5,중앙동,여성,1758,42,1800
3512,2021,5,천지동,남성,1755,58,1813
3513,2021,5,천지동,여성,1722,56,1778
3514,2021,5,추자면,남성,870,244,1114
3515,2021,5,추자면,여성,753,11,764
3516,2021,5,표선면,남성,6314,219,6533
3517,2021,5,표선면,여성,6023,120,6143
3518,2021,5,한경면,남성,4614,234,4848
3519,2021,5,한경면,여성,4536,102,4638
3520,2021,5,한림읍,남성,10891,2095,12986
3521,2021,5,한림읍,여성,10302,1147,11449
3522,2021,5,화북동,남성,12073,175,12248
3523,2021,5,화북동,여성,12230,161,12391
3524,2021,5,효돈동,남성,2661,41,2702
3525,2021,5,효돈동,여성,2605,19,2624
3526,2021,6,건입동,남성,4512,138,4650
3527,2021,6,건입동,여성,4371,89,4460
3528,2021,6,구좌읍,남성,7920,392,8312
3529,2021,6,구좌읍,여성,7481,162,7643
3530,2021,6,남원읍,남성,9668,427,10095
3531,2021,6,남원읍,여성,9049,210,9259
3532,2021,6,노형동,남성,27144,1151,28295
3533,2021,6,노형동,여성,28241,937,29178
3534,2021,6,대륜동,남성,7638,93,7731
3535,2021,6,대륜동,여성,7446,100,7546
3536,2021,6,대정읍,남성,10687,863,11550
3537,2021,6,대정읍,여성,11272,708,11980
3538,2021,6,대천동,남성,7048,71,7119
3539,2021,6,대천동,여성,6817,110,6927
3540,2021,6,도두동,남성,1730,43,1773
3541,2021,6,도두동,여성,1583,47,1630
3542,2021,6,동홍동,남성,11316,431,11747
3543,2021,6,동홍동,여성,11889,461,12350
3544,2021,6,봉개동,남성,2721,33,2754
3545,2021,6,봉개동,여성,2525,48,2573
3546,2021,6,삼도1동,남성,6627,51,6678
3547,2021,6,삼도1동,여성,6886,87,6973
3548,2021,6,삼도2동,남성,4114,145,4259
3549,2021,6,삼도2동,여성,3825,105,3930
3550,2021,6,삼양동,남성,12947,82,13029
3551,2021,6,삼양동,여성,12850,142,12992
3552,2021,6,서홍동,남성,5401,73,5474
3553,2021,6,서홍동,여성,5524,56,5580
3554,2021,6,성산읍,남성,8105,1029,9134
3555,2021,6,성산읍,여성,7373,465,7838
3556,2021,6,송산동,남성,2141,363,2504
3557,2021,6,송산동,여성,1903,103,2006
3558,2021,6,아라동,남성,18962,566,19528
3559,2021,6,아라동,여성,19397,471,19868
3560,2021,6,안덕면,남성,6306,248,6554
3561,2021,6,안덕면,여성,5899,261,6160
3562,2021,6,애월읍,남성,19122,466,19588
3563,2021,6,애월읍,여성,18215,495,18710
3564,2021,6,연동,남성,20525,865,21390
3565,2021,6,연동,여성,21385,1010,22395
3566,2021,6,영천동,남성,2618,112,2730
3567,2021,6,영천동,여성,2528,43,2571
3568,2021,6,예래동,남성,2013,109,2122
3569,2021,6,예래동,여성,1902,128,2030
3570,2021,6,오라동,남성,7969,89,8058
3571,2021,6,오라동,여성,7779,127,7906
3572,2021,6,외도동,남성,11061,98,11159
3573,2021,6,외도동,여성,11025,176,11201
3574,2021,6,용담1동,남성,3559,30,3589
3575,2021,6,용담1동,여성,3378,58,3436
3576,2021,6,용담2동,남성,7409,65,7474
3577,2021,6,용담2동,여성,7166,132,7298
3578,2021,6,우도면,남성,903,15,918
3579,2021,6,우도면,여성,819,14,833
3580,2021,6,이도1동,남성,3739,54,3793
3581,2021,6,이도1동,여성,3798,76,3874
3582,2021,6,이도2동,남성,24299,241,24540
3583,2021,6,이도2동,여성,25254,322,25576
3584,2021,6,이호동,남성,2356,81,2437
3585,2021,6,이호동,여성,2164,74,2238
3586,2021,6,일도1동,남성,1309,42,1351
3587,2021,6,일도1동,여성,1156,35,1191
3588,2021,6,일도2동,남성,16077,75,16152
3589,2021,6,일도2동,여성,16569,200,16769
3590,2021,6,정방동,남성,1078,64,1142
3591,2021,6,정방동,여성,1054,48,1102
3592,2021,6,조천읍,남성,13017,279,13296
3593,2021,6,조천읍,여성,12422,242,12664
3594,2021,6,중문동,남성,5938,151,6089
3595,2021,6,중문동,여성,5625,154,5779
3596,2021,6,중앙동,남성,1605,32,1637
3597,2021,6,중앙동,여성,1753,40,1793
3598,2021,6,천지동,남성,1754,60,1814
3599,2021,6,천지동,여성,1712,55,1767
3600,2021,6,추자면,남성,874,240,1114
3601,2021,6,추자면,여성,752,11,763
3602,2021,6,표선면,남성,6314,211,6525
3603,2021,6,표선면,여성,6033,123,6156
3604,2021,6,한경면,남성,4627,237,4864
3605,2021,6,한경면,여성,4531,100,4631
3606,2021,6,한림읍,남성,10891,2090,12981
3607,2021,6,한림읍,여성,10341,1140,11481
3608,2021,6,화북동,남성,12062,169,12231
3609,2021,6,화북동,여성,12238,161,12399
3610,2021,6,효돈동,남성,2660,39,2699
3611,2021,6,효돈동,여성,2597,18,2615
